Άγκυρα	αγκυρ	noun-fem-α
Άδωνις	Άδωνις	propn
Άρτεμις	Άρτεμις	propn
Άσαντ	Άσαντ	propn
Έβρος	Έβρος	propn
Έλληνας	Έλληνας	propn
Έντουαρντ	Έντουαρντ	propn
Έρικ	Έρικ	propn
Ήπειρος	Ήπειρος	propn
Όλγα	Όλγα	propn
Όλυμπος	Όλυμπος	propn
Όμηρος	Όμηρος	propn
Ύδρα	Ύδρα	propn
Α'	Α'	adj
Αίγυπτος	Αίγυπτος	propn
Αβάνα	Αβάνα	propn
Αγγλία	Αγγλία	propn
Αθήνα	Αθήνα	propn
Αιγαίο	Αιγαίο	propn
Αλέξανδρος	Αλέξανδρος	propn
Αλίκη	Αλίκη	propn
Αλαμπάμα	Αλαμπάμα	propn
Αλβανός	Αλβανός	propn
Αλγέρι	Αλγέρι	propn
Αλγερία	Αλγερία	propn
Αλεξάντερ	Αλεξάντερ	propn
Αλόννησο	Αλόννησο	propn
Αλόννησος	Αλόννησος	propn
Αμερική	Αμερική	propn
Αμερικανός	Αμερικανός	propn
Αμπάς	Αμπάς	propn
Αμπντελμαλέκ	Αμπντελμαλέκ	propn
Αμπντουραμάν	Αμπντουραμάν	propn
Αμπχαζία	Αμπχαζία	propn
Αμυράς	Αμυράς	propn
Ανίτα	Ανίτα	propn
Αναγκιά	Αναγκιά	propn
Ανθόπουλος	Ανθόπουλος	propn
Αξιός	Αξιός	propn
Απολλωνία	Απολλωνία	propn
Απρίλιος	Απρίλιος	propn
Αρίλλας	Αρίλλας	propn
Αργεντινή	Αργεντινή	propn
Αργεντινός	Αργεντινός	propn
Αριστερά	Αριστερά	noun
Αρκάνσας	Αρκάνσας	propn
Αρμενία	Αρμενία	propn
Αρτεμώνας	Αρτεμώνας	propn
Ασία	Ασία	propn
Αυστρία	Αυστρία	propn
Αυστραλία	Αυστραλία	propn
Αυστροουγγαρία	Αυστροουγγαρία	propn
Αφγανός	Αφγανός	propn
Αχέροντας	Αχέροντας	propn
Αχερουσία	Αχερουσία	propn
Β'	Β'	adj
Β.	Β.	noun
Βέλγιο	Βέλγιο	propn
Βαγδάτη	Βαγδάτη	propn
Βαλεαρίδες	Βαλεαρίδες	propn
Βαλκάνια	Βαλκάνια	propn
Βαλκανική	Βαλκανική	adj
Βαρκελώνη	Βαρκελώνη	propn
Βασίλειος	Βασίλειος	propn
Βεατρίκη	Βεατρίκη	propn
Βεγγάζη	Βεγγάζη	propn
Βενετία	Βενετία	propn
Βενιαμίν	Βενιαμίν	propn
Βενιζέλος	Βενιζέλος	propn
Βερολίνο	Βερολίνο	propn
Βλαντιμίρ	Βλαντιμίρ	propn
Βουλγαρία	Βουλγαρία	propn
Βούλγαρος	Βούλγαρος	propn
Βρετανός	Βρετανός	propn
Βρυξέλλες	Βρυξέλλες	propn
Γ'	Γ'	adj
Γάλλος	Γάλλος	propn
Γαλλία	Γαλλία	propn
Γαλλικά	Γαλλικά	propn
Γαλλική	Γαλλική	adj
Γενεύη	Γενεύη	propn
Γερμανία	Γερμανία	propn
Γερμανική	Γερμανική	adj
Γερμανός	Γερμανός	propn
Γεωργία	Γεωργία	propn
Γεωργιάδης	Γεωργιάδης	propn
Γεώργιος	Γεώργιος	propn
Γιάννης	Γιάννης	propn
Γιαπωνέζος	Γιαπωνέζος	propn
Γιουγκοσλαβία	Γιουγκοσλαβία	propn
Γιούντορ	Γιούντορ	propn
Γιούρα	γιουρ	noun-fem-α
Γιώργος	Γιώργος	propn
Γκιουνές	Γκιουνές	propn
Γλαύκος	Γλαύκος	propn
Γουλιέλμος	Γουλιέλμος	propn
Γρηγόριος	Γρηγόριος	propn
Γρυπάρης	Γρυπάρης	propn
Δήμος	δημ	noun-masc-ος
Δαγκλή	Δαγκλή	propn
Δανία	Δανία	propn
Δεκέμβριος	Δεκέμβριος	propn
Δευτέρα	δευτερ	noun-fem-α
Δευτέρας	Δευτέρας	propn
Δηλιγιάννης	Δηλιγιάννης	propn
Δημήτριος	Δημήτριος	propn
Διονύσιος	Διονύσιος	propn
Ε'	Ε'	adj
Εβραίος	Εβραίος	propn
Εγκέλαδος	Εγκέλαδος	propn
Εγκίζ	Εγκίζ	propn
Εγναντία	Εγναντία	propn
Εικονίστρα	εικονιστρ	noun-fem-α
Εκβατήριος	εκβατηρι	adj-ος
Ελένη	Ελένη	propn
Ελβετία	Ελβετία	propn
Ελλάδα	Ελλάδα	propn
Ελλάς	Ελλάς	propn
Ελληνοκύπριος	Ελληνοκύπριος	propn
Ελσίνκι	Ελσίνκι	propn
Ενετός	Ενετός	propn
Επτανήσιος	Επτανήσιος	propn
Ερετριεύς	Ερετριεύς	propn
Ερυθραία	Ερυθραία	propn
Ευρωπαίος	Ευρωπαίος	propn
Ευρώπη	Ευρώπη	propn
Ζάβια	Ζάβια	propn
Ζέρη	Ζέρη	propn
Ζαΐμης	ζαιμ	noun-masc-ης
Ζαν	Ζαν	propn
Ζαϊμης	Ζαϊμης	propn
Ηγουμενίτσα	Ηγουμενίτσα	propn
Θάσος	Θάσος	propn
Θεσπρωτία	Θεσπρωτία	propn
Θεσπρωτός	Θεσπρωτός	propn
Θεσσαλία	Θεσσαλία	propn
Θεσσαλονίκη	Θεσσαλονίκη	propn
Θεόδωρος	Θεόδωρος	propn
Θράκη	Θράκη	propn
ΙΣΑ	ΙΣΑ	adv
Ιανουάριο	ιανουαρ	noun-neut-ο
Ιανουάριος	Ιανουάριος	propn
Ιαπωνία	Ιαπωνία	propn
Ινδία	Ινδία	propn
Ιούλιος	Ιούλιος	propn
Ιούνιος	Ιούνιος	propn
Ισλανδία	Ισλανδία	propn
Ισπανία	Ισπανία	propn
Ισπανός	Ισπανός	propn
Ισραηλινή	Ισραηλινή	propn
Ισραηλοαμερικανική	Ισραηλοαμερικανική	adj
Ιταλία	ιταλια	noun-fem-α
Ιωάννης	Ιωάννης	propn
Ιωάννινα	Ιωάννινα	propn
Ιόνιο	Ιόνιο	adj
Κάιντα	Κάιντα	propn
Κάλαχαν	Κάλαχαν	propn
Κέρι	Κέρι	propn
Κέρκυρα	Κέρκυρα	propn
Κίνα	Κίνα	propn
Καλιφόρνια	Καλιφόρνια	propn
Καλογερόπουλος	Καλογερόπουλος	propn
Καλυβίδου	Καλυβίδου	propn
Καμπλία	Καμπλία	propn
Καναδάς	Καναδάς	propn
Καπιτώλιο	Καπιτώλιο	propn
Καραμανλής	Καραμανλής	propn
Κατσώνης	Κατσώνης	propn
Καύκασος	Καύκασος	propn
Κερκυραίος	Κερκυραίος	propn
Κερύνεια	Κερύνεια	propn
Κιμ	Κιμ	propn
Κινέζος	Κινέζος	propn
Κιργισίας	Κιργισίας	propn
Κισίντα	Κισίντα	propn
Κλίντον	Κλίντον	propn
Κληρίδης	Κληρίδης	propn
Κοπεγχάγη	Κοπεγχάγη	propn
Κορέα	Κορέα	propn
Κορίνθιος	Κορίνθιος	propn
Κορυφώ	Κορυφώ	propn
Κορφού	Κορφού	propn
Κουανγκτόνγκ	Κουανγκτόνγκ	propn
Κουντουριώτης	Κουντουριώτης	propn
Κούβα	Κούβα	propn
Κρήτη	Κρήτη	propn
Κρεμλίνο	Κρεμλίνο	propn
Κρητική	Κρητική	adj
Κρητικός	Κρητικός	propn
Κριμαία	Κριμαία	propn
Κυριακή	κυριακ	noun-fem-η
Κωνσταντίνος	Κωνσταντίνος	propn
Κωνσταντινούπολη	Κωνσταντινούπολη	propn
Κύπριος	Κύπριος	propn
Κύπρος	Κύπρος	propn
Λ'Άκουιλα	Λ'Άκουιλα	propn
Λάμπρος	Λάμπρος	propn
Λίνδος	Λίνδος	propn
Λίον	Λίον	propn
Λε	Λε	propn
Λευκορωσία	Λευκορωσία	propn
Λευκωσία	Λευκωσία	propn
Λιβύη	Λιβύη	propn
Λιθουανία	Λιθουανία	propn
Λιου	Λιου	propn
Λισσαβώνα	Λισσαβώνα	propn
Λουιζιάνα	Λουιζιάνα	propn
Λουκάς	Λουκάς	propn
Λουξεμβούργο	Λουξεμβούργο	propn
Μάιος	Μάιος	propn
Μάλι	Μάλι	propn
Μάλικι	Μάλικι	propn
Μάλτα	Μάλτα	propn
Μάρκος	Μάρκος	propn
Μάρτιος	Μάρτιος	propn
Μαγκρέμπ	Μαγκρέμπ	propn
Μαδρίτη	Μαδρίτη	propn
Μακεδονία	Μακεδονία	propn
Μαλάξα	Μαλάξα	propn
Μανδράκι	Μανδράκι	propn
Μαρίνα	Μαρίνα	propn
Μαριάνες	Μαριάνες	propn
Μαρόκο	Μαρόκο	propn
Μαυριτανός	Μαυριτανός	propn
Μαυροβούνιος	μαυροβουνι	adj-ος
Μαχμούντ	Μαχμούντ	propn
Μεντβέντεφ	Μεντβέντεφ	propn
Μεξικό	Μεξικό	propn
Μερκάλι	μερκαλι	noun-neut-ι
Μεσόγειος	Μεσόγειος	propn
Μετζλίς	Μετζλίς	propn
Μισισιπή	Μισισιπή	propn
Μισισιπής	Μισισιπής	propn
Μισουράτα	Μισουράτα	propn
Μισουράτας	Μισουράτας	propn
Μισράτας	Μισράτας	propn
Μιχαήλ	Μιχαήλ	propn
Μοχάμουντ	Μοχάμουντ	propn
Μούρτος	Μούρτος	propn
Μπάιντεν	Μπάιντεν	propn
Μπάμπα	Μπάμπα	propn
Μπαράκ	Μπαράκ	propn
Μπαρόζο	Μπαρόζο	propn
Μπασάρ	Μπασάρ	propn
Μπαχτσισαράι	Μπαχτσισαράι	propn
Μπιλ	Μπιλ	propn
Μπολόνια	Μπολόνια	propn
Μόσχα	Μόσχα	propn
Ν.	Ν.	noun
ΝΕΟΛΑΙΑ	ΝΕΟΛΑΙΑ	noun
Νέστος	Νέστος	propn
Νίκη	νικ	noun-fem-η
Νετανιάχου	Νετανιάχου	propn
Νευροκόπι	Νευροκόπι	propn
Νικολά	Νικολά	propn
Νικοτσάρας	Νικοτσάρας	propn
Νικόλαος	Νικόλαος	propn
Νοέμβριος	Νοέμβριος	propn
Νορβηγία	Νορβηγία	propn
Νορβηγός	νορβηγ	noun-neut-ι
Νούρι	Νούρι	propn
Νταχού	Νταχού	propn
Ντελφίν	Ντελφίν	propn
Ντιαογιού	Ντιαογιού	propn
Ντμίτρι	Ντμίτρι	propn
Ντριαν	Ντριαν	propn
Νύμφωνας	Νύμφωνας	propn
Οδυσσέας	Οδυσσέας	propn
Οθωμανός	Οθωμανός	propn
Οικονομικός	οικονομικ	adj-ός
Οκλαχόμα	Οκλαχόμα	propn
Οκτώβριο	οκτωβρ	noun-neut-ο
Οκτώβριος	Οκτώβριος	propn
Ολλανδή	Ολλανδή	propn
Ολλανδία	Ολλανδία	propn
Ολλανδός	Ολλανδός	propn
Ομπάμα	Ομπάμα	propn
Ονα	ον	noun-fem-α
Οσάμου	Οσάμου	propn
Οσετία	Οσετία	propn
Ουκρανία	Ουκρανία	propn
Ουμάρ	Ουμάρ	propn
Οχρίδα	οχριδ	noun-fem-α
Ούντερλιν	Ούντερλιν	propn
Πάτρα	Πάτρα	propn
Πέμπτη	Πέμπτη	propn
Πέρσης	Πέρσης	propn
Πίζα	Πίζα	propn
Πίνδος	Πίνδος	propn
Παλαιοιλιθική	Παλαιοιλιθική	adj
Πανέτα	Πανέτα	propn
Παναγία	Παναγία	propn
Παναγιώτης	Παναγιώτης	propn
Παπαβλαχάβας	Παπαβλαχάβας	propn
Παρίσι	Παρίσι	propn
Παρασκευή	παρασκευ	noun-fem-η
Παύλος	Παύλος	propn
Πεκίνο	Πεκίνο	propn
Πετρούπολη	Πετρούπολη	propn
Πιονγκγιάνγκ	Πιονγκγιάνγκ	propn
Πορτογάλος	Πορτογάλος	propn
Πορτογαλία	Πορτογαλία	propn
Ποσειδώνας	Ποσειδώνας	propn
Πούσκιν	Πούσκιν	propn
Πούτιν	Πούτιν	propn
Πράγα	Πράγα	propn
Πρέσπες	Πρέσπες	propn
Ράλλης	Ράλλης	propn
Ρέθυμνο	Ρέθυμνο	propn
Ρένια	Ρένια	propn
Ρίλας	Ρίλας	propn
Ρίτσαρντσον	Ρίτσαρντσον	propn
Ροδόπη	Ροδόπη	propn
Ρωμαίος	Ρωμαίος	propn
Ρωσία	Ρωσία	propn
Ρωσική	Ρωσική	adj
Ρόδος	Ρόδος	propn
Ρώσος	Ρώσος	propn
ΣΥΜΜΕΤΡΙΑ	ΣΥΜΜΕΤΡΙΑ	noun
ΣΩΚΡΑΤΗΣ	ΣΩΚΡΑΤΗΣ	propn
Σάββας	Σάββας	propn
Σέβρες	Σέβρες	propn
Σέρβος	Σέρβος	propn
Σίφνος	Σίφνος	propn
Σαμψών	Σαμψών	propn
Σαρκοζί	Σαρκοζί	propn
Σεΐχ	Σεΐχ	propn
Σελάλ	Σελάλ	propn
Σενκάκου	Σενκάκου	propn
Σεούλ	Σεούλ	propn
Σεπτέμβριος	Σεπτέμβριος	propn
Σερβία	Σερβία	propn
Σερεμέτιεβο	Σερεμέτιεβο	propn
Σιίτων	Σιίτων	propn
Σινόμπε	Σινόμπε	propn
Σκάντουρα	σκαντουρ	noun-fem-α
Σκίαθο	Σκίαθο	propn
Σκιάθος	Σκιάθος	propn
Σκουλούδης	Σκουλούδης	propn
Σκόπια	Σκόπια	propn
Σλάβος	Σλάβος	propn
Σλαβομακεδόνας	Σλαβομακεδόνας	propn
Σμιτ	Σμιτ	propn
Σμύρνη	Σμύρνη	propn
Σνόουντεν	Σνόουντεν	propn
Σολωμός	Σολωμός	propn
Σομαλία	Σομαλία	propn
Σουνγκ	Σουνγκ	propn
Σοφία	Σοφία	propn
Σούλι	Σούλι	propn
Σπιανάδα	Σπιανάδα	propn
Σποράδες	Σποράδες	propn
Σπυρίδωνας	Σπυρίδωνας	propn
Στάφο	Στάφο	propn
Σταθάς	Σταθάς	propn
Σταϊκούρας	Σταϊκούρας	propn
Στρασβούργο	Στρασβούργο	propn
Στροφυλιά	Στροφυλιά	propn
Στρυμόνας	Στρυμόνας	propn
Συμεωνίδης	Συμεωνίδης	propn
Συμεών	Συμεών	propn
Συρία	Συρία	propn
Σύβοτα	Σύβοτα	propn
Σύρος	Σύρος	propn
Τάταρος	Τάταρος	propn
Τακαμάτσου	Τακαμάτσου	propn
Τατάρους	Τατάρους	propn
Τατάρων	Τατάρων	propn
Τετάρτη	τεταρτ	noun-fem-η
Τεχεράνη	Τεχεράνη	propn
Τζακ	Τζακ	propn
Τζο	Τζο	propn
Τζων	Τζων	propn
Τουλούζη	Τουλούζη	propn
Τουρκία	Τουρκία	propn
Τουρκικά	Τουρκικά	adj
Τουρκοκύπριος	Τουρκοκύπριος	propn
Τούρκος	Τούρκος	propn
Τρίπολη	Τρίπολη	propn
Τρίτη	Τρίτη	propn
Τσετσενία	Τσετσενία	propn
Τσιτσιμπίκου	Τσιτσιμπίκου	propn
Τόκυο	Τόκυο	propn
Υβ	Υβ	propn
Υεμένη	Υεμένη	propn
Υόρκη	Υόρκη	propn
Φαλούτζα	Φαλούτζα	propn
Φεβρουάριος	Φεβρουάριος	propn
Φούμιο	Φούμιο	propn
Χίλαρι	Χίλαρι	propn
Χίος	Χίος	propn
Χαμάχα	Χαμάχα	propn
Χανάτου	Χανάτου	propn
Χανιά	Χανιά	propn
Χασσάν	Χασσάν	propn
Χασσάντ	Χασσάντ	propn
Χατζηδάκης	Χατζηδάκης	propn
Χατζησταμάτης	Χατζησταμάτης	propn
Χομς	Χομς	propn
Χουάν	Χουάν	propn
Χρήστος	Χρήστος	propn
Χριστούγεννα	Χριστούγεννα	propn
Χρυσέογλου	Χρυσέογλου	propn
Χρυσοπηγή	χρυσοπηγ	noun-fem-η
Ψαθούρα	ψαθουρ	noun-fem-α
άγιος	αγι	noun-masc-ος
άγνωστος	αγνωστ	adj-ος
άγρια	άγρια	adv
άγριος	αγρι	adj-ος
άδεια	αδει	noun-fem-α
άδης	άδης	propn
άζωτο	αζωτ	noun-neut-ο
άκαμπτος	ακαμπτ	adj-ος
άκρο	ακρ	noun-neut-ο
άλλοθι	αλλοθι	noun-neut-ι
άλλος	άλλος	det
άλλως	άλλως	adv
άλλωστε	άλλωστε	adv
άμαχος	αμαχ	noun-masc-ος
άμεσα	άμεσα	adv
άμεσος	αμεσ	adj-ος
άμμος	αμμο	noun-masc-ος
άμυνα	αμυν	noun-fem-α
άνεμος	ανεμ	noun-masc-ος
άνεργος	ανεργο	noun-masc-ος
άνευ	άνευ	adp
άνθρωπος	ανθρωπ	noun-masc-ος
άνισος	ανισ	adj-ος
άνοδος	ανοδ	noun-masc-ος
άνοιγμα	ανοιγμα	noun-neut-μα
άντρας	αντρ	noun-masc-ας
άνω	άνω	adj
άξιος	αξι	adj-ος
άξονας	αξον	noun-masc-ας
άπελπις	άπελπις	adj
άποικος	αποικο	noun-masc-ος
άπορος	απορ	adj-ος
άποψη	αποψ	noun-fem-η
άπραγος	απραγ	adj-ος
άρθρο	αρθρ	noun-neut-ο
άριστος	αριστ	adj-ος
άρνηση	αρνηση	noun-fem-η
άρρωστος	αρρωστ	adj-ος
άρση	αρση	noun-fem-η
άσθμα	ασθ	noun-neut-μα
άσκηση	ασκησ	noun-fem-η
άσκοπος	ασκοπ	adj-ος
άστεγος	αστεγ	adj-ος
άστοχος	αστοχ	adj-ος
άσυλο	ασυλ	noun-neut-ο
άσχημος	ασχημ	adj-ος
άτομο	ατομ	noun-neut-ο
άτυχος	ατυχ	adj-ος
έγγραφο	εγγραφ	noun-neut-ο
έγκαιρος	εγκαιρ	adj-ος
έγκειται	εγκειται	verb-παθ
έγκλημα	εγκλημα	noun-neut-μα
έγκριση	εγκρισ	noun-fem-η
έδαφος	εδαφο	noun-masc-ος
έδρα	εδρ	noun-fem-α
έθιμο	εθιμ	noun-neut-ο
έθνος	εθν	noun-masc-ος
έκδοση	εκδοση	noun-fem-η
έκθεση	εκθεσ	noun-fem-η
έκκληση	εκκλησ	noun-fem-η
έκπτωση	εκπτωσ	noun-fem-η
έκπτωτος	εκπτωτ	adj-ος
έκρηξη	εκρηξ	noun-fem-η
έκτακτος	εκτακτ	adj-ος
έκτος	εκτ	adj-ος
έκφραση	εκφρασ	noun-fem-η
έλεγχος	ελεγχ	noun-masc-ος
έλευση	ελευσ	noun-fem-η
έλλειμμα	ελλειμμα	noun-neut-μα
έλλειψη	ελλειψ	noun-fem-η
έλξη	ελξ	noun-fem-η
έμβλημα	εμβλη	noun-neut-μα
έμπορος	εμπορ	noun-masc-ος
έμφαση	εμφασ	noun-fem-η
έναντι	έναντι	adp
έναρξη	εναρξ	noun-fem-η
ένας	ένας	det
ένδειξη	ενδειξ	noun-fem-η
ένθερμος	ενθερμ	adj-ος
έννοια	εννοι	noun-fem-α
ένοπλος	ενοπλ	adj-ος
ένορκος	ενορκ	adj-ος
ένοχος	ενοχο	adj-ος
ένταλμα	ενταλμα	noun-neut-μα
ένταξη	ενταξη	noun-fem-η
ένταση	εντασ	noun-fem-η
έντονος	εντον	adj-ος
ένωση	ενωση	noun-fem-η
έξαρση	εξαρσ	noun-fem-η
έξι	έξι	num
έξοδο	εξοδ	noun-neut-ο
έξοδος	εξοδο	noun-masc-ος
έξυπνος	εξυπν	adj-ος
έξω	έξω	adv
έπειτα	έπειτα	adv
έργο	εργ	noun-neut-ο
έρευνα	ερευν	noun-fem-α
έρημος	ερημ	noun-masc-ος
έρχομαι	ερχ	verb-παθ
έσοδο	εσοδ	noun-neut-ο
έστω	έστω	adv
έτοιμος	ετοιμ	adj-ος
έτος	ετ	noun-masc-ος
έτσι	έτσι	adv
έφεση	εφεσ	noun-fem-η
έχει	έχει	aux
έχουν	έχουν	aux
έχω	εχ	verb-a
έως	έως	adp
ή	ή	cconj
ήδη	ήδη	adv
ήπειρος	ηπειρ	noun-masc-ος
ήπιος	ηπι	adj-ος
ήταν	ήταν	aux
ήτοι	ήτοι	adv
ήττα	ηττ	noun-fem-α
ίδιος	ιδι	adj-ος
ίδρυμα	ιδρυ	noun-neut-μα
ίδρυση	ιδρυση	noun-fem-η
ίσος	ισ	adj-ος
ίσως	ίσως	adv
ίχνος	ιχν	noun-masc-ος
αέρας	αερ	noun-masc-ας
αέριο	αεριο	noun-neut-ο
αέριος	αερι	adj-ος
αέρος	αερ	noun-masc-ος
αίθουσα	αιθουσ	noun-fem-α
αίρω	αιρ	verb-a
αίτημα	αιτη	noun-neut-μα
αίτηση	αιτησ	noun-fem-η
αίτιο	αιτ	noun-neut-ο
αβάσιμος	αβασιμ	adj-ος
αβοήθητος	αβοηθητ	adj-ος
αγαθό	αγαθ	noun-neut-ο
αγαπητός	αγαπητ	adj-ός
αγγλικός	αγγλικ	adj-ός
αγιορείτης	αγιορειτ	adj-ης
αγνοούμενος	αγνοουμεν	adj-ος
αγνοώ	αγνο	verb-b2
αγορά	αγορά	noun
αγοράζω	αγορα	verb-a
αγοραστής	αγοραστ	noun-masc-ης
αγριελιά	αγριελιά	noun
αγριογούρουνο	αγριογουρουν	noun-neut-ο
αγριοκάτσικο	αγριοκατσικ	noun-neut-ο
αγωγή	αγωγ	noun-fem-η
αγωγός	αγωγ	noun-neut-ι
αγωνίζομαι	αγωνι	verb-παθ
αγωνιστής	αγωνιστ	noun-masc-ης
αγόρι	αγορι	noun-neut-ι
αγώνας	αγωνα	noun-masc-ας
αδέρφι	αδε	noun-neut-ι
αδίκημα	αδικημα	noun-neut-μα
αδελφοποίηση	αδελφοποιησ	noun-fem-η
αδελφός	αδελφ	noun-neut-ι
αδιάθετος	αδιαθετ	adj-ος
αδιαμφισβήτητος	αδιαμφισβητητ	adj-ος
αδιανόητος	αδιανοητ	adj-ος
αδιευκρίνιστος	αδιευκρινιστ	adj-ος
αδικαιολόγητος	αδικαιολογητ	adj-ος
αδράνεια	αδρανει	noun-fem-α
αδρανής	αδραν	adj-ής
αδυναμία	αδυναμι	noun-fem-α
αδυνατώ	αδυνατ	verb-b2
αδύνατος	αδυνατ	adj-ος
αειφόρο	αειφόρο	adj
αειφόρος	αειφορο	adj-ος
αεροδρόμιο	αεροδρομιο	noun-neut-ο
αεροπλάνο	αεροπλαν	noun-neut-ο
αεροπορικά	αεροπορικά	adv
αεροπορικός	αεροπορικ	adj-ός
αεροσκάφος	αεροσκαφ	noun-masc-ος
αθέμιτος	αθεμιτ	adj-ος
αθωότητα	αθωοτητα	noun-fem-α
αθώος	αθω	adj-ος
αιγίδα	αιγιδ	noun-fem-α
αιγυπτιακός	αιγυπτιακ	adj-ός
αιγόγλαρος	αιγογλαρ	noun-masc-ος
αιμολυτικός	αιμολυτικ	adj-ός
αισθάνομαι	αισθαν	verb-παθ
αισθητής	αισθητ	adj-ής
αισιοδοξία	αισιοδοξι	noun-fem-α
αιτία	αιτι	noun-fem-α
αιτιολογικός	αιτιολογικ	adj-ός
αιτιολογώ	αιτιολογ	verb-b2
αιχμάλωτος	αιχμαλωτο	adj-ος
αιχμαλωτίζω	αιχμαλωτιζ	verb-a
αιώνας	αιων	noun-masc-ας
ακάλυπτος	ακαλυπτ	adj-ος
ακαδημία	ακαδημία	propn
ακατανόητος	ακατανοητ	adj-ος
ακατοίκητος	ακατοικητ	adj-ος
ακατόρθωτος	ακατορθωτ	adj-ος
ακινησία	ακινησι	noun-fem-α
ακμάζω	ακμαζ	verb-a
ακολουθώ	ακολουθ	verb-b2
ακούω	ακου	verb-a
ακραίος	ακραι	adj-ος
ακριβά	ακριβά	adv
ακριβής	ακριβ	adj-ής
ακριβώς	ακριβώς	adv
ακροαματικός	ακροαματικ	adj-ός
ακρογωνιαίος	ακρογωνιαι	adj-ος
ακρωτήρι	ακρωτηρι	noun-neut-ι
ακρόαση	ακροασ	noun-fem-η
ακρόπολη	ακροπολ	noun-fem-η
ακτίνα	ακτιν	noun-fem-α
ακτιβιστής	ακτιβιστ	noun-masc-ης
ακτοπλοΐα	ακτοπλοι	noun-fem-α
ακυρωτικός	ακυρωτικ	adj-ός
ακυρώνω	ακυρω	verb-a
ακόλουθος	ακολουθ	adj-ος
ακόμα	ακόμα	adv
ακύρωση	ακυρωσ	noun-fem-η
αλήθεια	αλήθεια	adv
αλγερινός	αλγεριν	adj-ός
αλεξίπτωτο	αλεξιπτωτ	noun-neut-ο
αλεξιπτωτιστής	αλεξιπτωτιστ	noun-masc-ης
αληθεύω	αληθευ	verb-a
αλλά	αλλά	cconj
αλλάζω	αλλαζ	verb-a
αλλαγή	αλλαγ	noun-fem-η
αλλεπάλληλος	αλλεπαλληλ	adj-ος
αλληλεγγύη	αλληλεγγυ	noun-fem-η
αλληλεπίδραση	αλληλεπιδρασ	noun-fem-η
αλλοδαπός	αλλοδαπ	adj-ός
αλλού	αλλού	adv
αλυκή	αλυκή	propn
αλφαβητισμός	αλφαβητισμ	noun-neut-ι
αλύτρωτος	αλυτρωτ	adj-ος
αμάξι	αμαξι	noun-neut-ι
αμέσως	αμέσως	adv
αμερικάνικος	αμερικανικ	adj-ος
αμνηστία	αμνηστία	propn
αμοιβαίος	αμοιβαι	adj-ος
αμφιλεγόμενος	αμφιλεγομεν	adj-ος
αμφισβήτηση	αμφισβητησ	noun-fem-η
αμφισβητούμενος	αμφισβητουμεν	adj-ος
αμφισβητώ	αμφισβητ	verb-b2
αμύνομαι	αμυν	verb-παθ
αν	αν	sconj
ανά	ανά	adp
ανάγκη	αναγκ	noun-fem-η
ανάγνωση	αναγνωσ	noun-fem-η
ανάδοχος	αναδοχο	noun-masc-ος
ανάθεση	αναθεση	noun-fem-η
ανάκαμψη	ανακαμψ	noun-fem-η
ανάκρουση	ανακρουσ	noun-fem-η
ανάκτηση	ανακτησ	noun-fem-η
ανάκτορο	ανακτορ	noun-neut-ο
ανάληψη	αναληψ	noun-fem-η
ανάλογα	ανάλογα	adv
ανάλογος	αναλογ	adj-ος
ανάλυση	αναλυσ	noun-fem-η
ανάλωση	αναλωσ	noun-fem-η
ανάμεικτος	αναμεικτ	adj-ος
ανάμειξη	αναμειξ	noun-fem-η
ανάμεσα	ανάμεσα	adv
ανάπαυση	αναπαυσ	noun-fem-η
ανάπλαση	αναπλασ	noun-fem-η
ανάπτυξη	αναπτυξη	noun-fem-η
ανέρχομαι	ανερχ	verb-παθ
ανήκω	ανηκ	verb-a
αναβάλλω	αναβαλλ	verb-a
αναβολή	αναβολ	noun-fem-η
αναγκάζω	αναγκα	verb-a
αναγκαίος	αναγκαι	adj-ος
αναγκαιότητα	αναγκαιοτητ	noun-fem-α
αναγκαστικά	αναγκαστικά	adv
αναγκαστικός	αναγκαστικ	adj-ός
αναγνωρίζω	αναγνωρι	verb-a
αναγνώριση	αναγνωριση	noun-fem-η
αναδεικνύω	αναδεικνυ	verb-a
αναδιάρθρωση	αναδιαρθρωσ	noun-fem-η
αναδιπλώνω	αναδιπλων	verb-a
αναζήτηση	αναζητησ	noun-fem-η
αναζητώ	αναζητ	verb-b2
αναζωογόνηση	αναζωογονησ	noun-fem-η
αναθέτουσα	αναθέτουσα	adj
αναθέτω	αναθετ	verb-a
αναθέτων	αναθέτων	adj
αναθεωρώ	αναθεωρ	verb-b2
αναθεώρηση	αναθεωρηση	noun-fem-η
ανακάλυψη	ανακαλυψ	noun-fem-η
ανακάμπτω	ανακαμπτ	verb-a
ανακήρυξη	ανακηρυξ	noun-fem-η
ανακαίνιση	ανακαινισ	noun-fem-η
ανακαλύπτω	ανακαλυπτ	verb-a
ανακατασκευή	ανακατασκευ	noun-fem-η
ανακηρύσσω	ανακηρυσσ	verb-a
ανακοίνωση	ανακοινωσ	noun-fem-η
ανακοινώνω	ανακοινω	verb-a
ανακούφιση	ανακουφισ	noun-fem-η
ανακριτής	ανακριτ	adj-ής
ανακτώ	ανακτ	verb-b2
ανακωχή	ανακωχ	noun-fem-η
ανακόλουθος	ανακολουθ	adj-ος
ανακόπτω	ανακο	verb-a
ανακύπτω	ανακυπτ	verb-a
αναλαμβάνω	αναλαμβαν	verb-a
αναλογία	αναλογι	noun-fem-α
αναλογίζομαι	αναλογιζ	verb-παθ
αναλογικότητα	αναλογικοτητ	noun-fem-α
αναλογών	αναλογών	adj
αναλυτής	αναλυτ	noun-masc-ης
αναλυτικά	αναλυτικά	adv
αναλυτικός	αναλυτικ	adj-ός
αναλύω	αναλυ	verb-a
αναμένω	αναμεν	verb-a
αναμέτρηση	αναμετρησ	noun-fem-η
αναμφίβολα	αναμφίβολα	adv
ανανεώνω	ανανεων	verb-a
αναντίρρητα	αναντίρρητα	adv
αναπληρωτής	αναπληρωτ	noun-masc-ης
αναπληρώτρια	αναπληρώτρια	adj
αναπνευστικός	αναπνευστικ	adj-ός
αναπνοή	αναπνο	noun-fem-η
αναποτελεσματικότητα	αναποτελεσματικοτητ	noun-fem-α
αναπροσαρμογή	αναπροσαρμογ	noun-fem-η
αναπτυσσόμενος	αναπτυσσομεν	adj-ος
αναπτύσσω	αναπτυσσ	verb-a
αναρίθμητος	αναριθμητ	adj-ος
αναρωτιέμαι	αναρωτ	verb-
ανασκαφή	ανασκαφ	noun-fem-η
αναστέλλω	αναστελλ	verb-a
ανασταλτικά	ανασταλτικά	adv
αναστολή	αναστολ	noun-fem-η
ανασύρω	ανασυρ	verb-a
ανατολή	ανατολη	noun-fem-η
ανατολικά	ανατολικά	adv
ανατολικός	ανατολικ	adj-ός
ανατρέπω	ανατρεπ	verb-a
ανατροπή	ανατροπ	noun-fem-η
αναφέρω	αναφερ	verb-a
αναφερόμενος	αναφερομεν	adj-ος
αναφορά	αναφορά	noun
αναφορικά	αναφορικά	adv
αναχωρώ	αναχωρ	verb-b2
αναψυχή	αναψυχ	noun-fem-η
ανδρικός	ανδρικ	adj-ός
ανεμοστρόβιλος	ανεμοστροβιλ	noun-masc-ος
ανεμόμυλος	ανεμομυλ	noun-masc-ος
ανεξάρτητα	ανεξάρτητα	adv
ανεξάρτητος	ανεξαρτητ	adj-ος
ανεξαίρετα	ανεξαίρετα	adv
ανεξαρτησία	ανεξαρτησια	noun-fem-α
ανεπαρκής	ανεπαρκη	adj-ής
ανεπιθύμητος	ανεπιθυμητ	adj-ος
ανεπιφύλακτα	ανεπιφύλακτα	adv
ανεπτυγμένος	ανεπτυγμεν	adj-ος
ανεργία	ανεργια	noun-fem-α
ανεφοδιασμός	ανεφοδιασμ	noun-neut-ι
ανησυχία	ανησυχι	noun-fem-α
ανησυχητικός	ανησυχητικ	adj-ός
ανησυχώ	ανησυχ	verb-b2
ανθρωπιστικός	ανθρωπιστικ	adj-ός
ανθρωπότητα	ανθρωποτητ	noun-fem-α
ανθρώπινος	ανθρωπιν	adj-ος
ανοίγω	ανοι	verb-a
ανοικοδόμηση	ανοικοδομησ	noun-fem-η
ανοικτά	ανοικτά	adv
ανοιχτός	ανοι	adj-ός
ανοργάνωτος	ανοργανωτ	adj-ος
αντάρτης	ανταρτ	noun-masc-ης
αντάρτικος	ανταρτικ	adj-ος
αντί	αντί	adp
αντίδραση	αντιδρασ	noun-fem-η
αντίθετα	αντίθετα	adv
αντίκτυπος	αντικτυπ	noun-masc-ος
αντίπαλος	αντιπαλ	adj-ος
αντίποινο	αντιποιν	noun-neut-ο
αντίρρηση	αντιρρησ	noun-fem-η
αντίσταση	αντιστασ	noun-fem-η
αντίστοιχα	αντίστοιχα	adv
αντίστοιχος	αντιστοιχ	adj-ος
αντίτυπο	αντιτυπ	noun-neut-ο
ανταγωνισμός	ανταγωνισμο	noun-neut-ι
ανταγωνιστικός	ανταγωνιστικ	adj-ός
ανταλλάζω	ανταλλαζ	verb-a
ανταλλαγή	ανταλλαγ	noun-fem-η
ανταποκρίνομαι	ανταποκρι	verb-παθ
ανταπόδοση	ανταποδοσ	noun-fem-η
αντιβασίλισσα	αντιβασιλισσ	noun-fem-α
αντιβασιλέας	αντιβασιλε	noun-masc-ας
αντιδιαστολή	αντιδιαστολ	noun-fem-η
αντιδρώ	αντιδρ	verb-b2
αντιζηλία	αντιζηλι	noun-fem-α
αντικαθιστώ	αντικα	verb-b2
αντικατάσταση	αντικαταστασ	noun-fem-η
αντικατοπτρίζω	αντικατοπτριζ	verb-a
αντικείμενο	αντικειμεν	noun-neut-ο
αντικειμενικός	αντικειμενικ	adj-ός
αντικυβερνητικός	αντικυβερνητικ	adj-ός
αντιλαμβάνομαι	αντιλ	verb-παθ
αντιμέτωπος	αντιμετωπ	adj-ος
αντιμαχόμενος	αντιμαχομεν	adj-ος
αντιμετωπίζω	αντιμετωπι	verb-a
αντιμετώπιση	αντιμετωπιση	noun-fem-η
αντιπαράθεση	αντιπαραθεσ	noun-fem-η
αντιπαραθέτω	αντιπαραθετ	verb-a
αντιπολίτευση	αντιπολιτευση	noun-fem-η
αντιπροσωπεία	αντιπροσωπει	noun-fem-α
αντιπρόεδρος	αντιπροεδρ	noun-masc-ος
αντιπρόσωπος	αντιπροσωπο	noun-masc-ος
αντιστέκομαι	αντιστεκ	verb-παθ
αντισταθμίζω	αντισταθμιζ	verb-a
αντιστοιχία	αντιστοιχι	noun-fem-α
αντιστοιχώ	αντιστοιχ	verb-b2
αντιτίθεμαι	αντιτιθε	verb-
αντιτρομοκρατικός	αντιτρομοκρατικ	adj-ός
ανυπομονησία	ανυπομονησι	noun-fem-α
ανύπαρκτος	ανυπαρκτ	adj-ος
ανώνυμος	ανωνυμ	adj-ος
ανώτερος	ανωτ	adj-ος
αξία	αξι	noun-fem-α
αξίζω	αξιζ	verb-a
αξίωμα	αξιωμα	noun-neut-μα
αξίωση	αξιωσ	noun-fem-η
αξιοθέατος	αξιοθεατ	adj-ος
αξιολογώ	αξιολογ	verb-b2
αξιολόγηση	αξιολογησ	noun-fem-η
αξιοπιστία	αξιοπιστι	noun-fem-α
αξιοπρέπεια	αξιοπρεπει	noun-fem-α
αξιοσημείωτος	αξιοσημειωτ	adj-ος
αξιωματικός	αξιωματικ	noun-neut-ι
αξιωματούχος	αξιωματουχ	noun-masc-ος
αξιόλογος	αξιολογ	adj-ος
αξιόπιστος	αξιοπιστ	adj-ος
αξιότιμος	αξιοτιμ	adj-ος
απάγω	απαγ	verb-a
απάντηση	απαντηση	noun-fem-η
απάτη	απατ	noun-fem-η
απέναντι	απέναντι	adv
απαίτηση	απαιτησ	noun-fem-η
απαγορεύω	απαγορευ	verb-a
απαγωγή	απαγωγ	noun-fem-η
απαγόρευση	απαγορευσ	noun-fem-η
απαθανατίζω	απαθανατιζ	verb-a
απαιτώ	απαιτ	verb-b2
απαλλάσσω	απαλλασσ	verb-a
απαλλαγή	απαλλαγ	noun-fem-η
απαντώ	απαντ	verb-b2
απανωτός	απανωτ	adj-ός
απαράδεκτα	απαράδεκτα	adv
απαράδεκτος	απαραδεκτ	noun-masc-ος
απαρέγκλιτος	απαρεγκλιτ	adj-ος
απαραίτητος	απαραιτητ	adj-ος
απαρτίζω	απαρτιζ	verb-a
απαρτχάιντ	απαρτχάιντ	noun
απαρχαιωμένος	απαρχαιωμεν	verb-
απασχολημένος	απασχολημεν	verb-
απασχολώ	απασχολ	verb-b2
απασχόληση	απασχοληση	noun-fem-η
απεικόνιση	απεικονισ	noun-fem-η
απειλή	απειλ	noun-fem-η
απειλούμενος	απειλουμεν	adj-ος
απειλώ	απειλ	verb-b2
απελαύνω	απελαυν	verb-a
απελευθέρωση	απελευθερωσ	noun-fem-η
απελευθερωτικός	απελευθερωτικο	adj-ός
απελευθερώνω	απελευθερων	verb-a
απελπισμένος	απελπισμεν	adj-ος
απερίγραπτος	απεριγραπτ	adj-ος
απεργία	απεργι	noun-fem-α
απεσταλμένος	απεσταλμεν	noun-masc-ος
απευθείας	απευθείας	adv
απευθύνω	απευθυν	verb-a
απλά	απλά	adv
απλοποιώ	απλοποι	verb-b2
απλουστευτικός	απλουστευτικ	adj-ός
απλούστευση	απλουστευσ	noun-fem-η
απλός	απλ	adj-ός
απλώνω	απλων	verb-a
αποβαίνω	αποβ	verb-a
αποβιβάζω	αποβιβαζ	verb-a
αποβιώνω	αποβιων	verb-a
απογοήτευση	απογοητευσ	noun-fem-η
αποδέχομαι	αποδεχ	verb-παθ
αποδίδω	αποδ	verb-a
αποδεικνύω	αποδεικνυ	verb-a
αποδεκτός	αποδεκτ	adj-ός
αποδεσμεύω	αποδεσμευ	verb-a
αποδημητικός	αποδημητικ	adj-ός
αποδιδρώ	αποδιδρ	verb-b2
αποδοχή	αποδοχη	noun-fem-η
αποδρώ	αποδρ	verb-b2
αποδυναμώνω	αποδυναμων	verb-a
αποζημίωση	αποζημιωσ	noun-fem-η
αποικισμός	αποικισμ	noun-neut-ι
αποικώ	αποικ	verb-b2
αποκέντρωση	αποκεντρωσ	noun-fem-η
αποκαθιστώ	αποκα	verb-b2
αποκαλούμενος	αποκαλουμεν	adj-ος
αποκαλύπτω	αποκαλυ	verb-a
αποκαλώ	αποκαλ	verb-b2
αποκατάσταση	αποκαταστασ	noun-fem-η
αποκεντρώνω	αποκεντρω	verb-a
αποκλείω	αποκλει	verb-a
αποκλειστικά	αποκλειστικά	adv
αποκλειστικός	αποκλειστικ	adj-ός
αποκοιμίζω	αποκοιμιζ	verb-a
αποκοιμιέμαι	αποκοιμ	verb-
αποκτώ	αποκτ	verb-b2
απολαμβάνω	απολαμβαν	verb-a
απολαύω	απολαυ	verb-a
απολογισμός	απολογισμ	noun-neut-ι
απομακρύνω	απομακρυν	verb-a
απομόνωση	απομονωσ	noun-fem-η
αποπληρωμή	αποπληρωμ	noun-fem-η
αποποίηση	αποποιησ	noun-fem-η
απορία	απορι	noun-fem-α
απορρίπτω	απορριπτ	verb-a
απορροφώ	απορροφ	verb-b2
αποσαφηνίζω	αποσαφηνιζ	verb-a
αποσκοπώ	αποσκοπ	verb-b2
αποστέλλω	αποστελλ	verb-a
αποστολή	αποστολ	noun-fem-η
αποσύνθεση	αποσυνθεσ	noun-fem-η
αποσύρω	αποσυρ	verb-a
αποτέλεσμα	αποτελεσμα	noun-neut-μα
αποτελεσματικά	αποτελεσματικά	adv
αποτελεσματικός	αποτελεσματικ	adj-ός
αποτελεσματικότητα	αποτελεσματικοτητ	noun-fem-α
αποτελώ	αποτελ	verb-b2
αποτρέπω	αποτρεπ	verb-a
αποτυγχάνω	αποτυ	verb-a
αποτυπώνω	αποτυπων	verb-a
αποτυχία	αποτυχι	noun-fem-α
απουσία	απουσι	noun-fem-α
απουσιάζω	απουσιαζ	verb-a
αποφέρω	αποφερ	verb-a
αποφαίνομαι	αποφαιν	verb-παθ
αποφασίζω	αποφασι	verb-a
αποφασισμένος	αποφασισμεν	adj-ος
αποφασιστικός	αποφασιστικ	adj-ός
αποφασιστικότητα	αποφασιστικοτητα	noun-fem-α
αποφεύγω	αποφ	verb-a
αποχωρώ	αποχωρ	verb-b2
αποχώρηση	αποχωρησ	noun-fem-η
απροχώρητος	απροχωρητ	adj-ος
απρόσκοπτος	απροσκοπτ	adj-ος
απτός	απτ	adj-ός
από	από	adp
απόγευμα	απογευ	noun-neut-μα
απόδειξη	αποδειξ	noun-fem-η
απόδοση	αποδοσ	noun-fem-η
απόκτηση	αποκτηση	noun-fem-η
απόλυση	απολυσ	noun-fem-η
απόλυτα	απόλυτα	adv
απόλυτος	απολυτ	adj-ος
απόπειρα	αποπειρα	noun-fem-α
απόρρητος	απορρητ	adj-ος
απόρριψη	απορριψ	noun-fem-η
απόσταση	αποστασ	noun-fem-η
απόσυρση	αποσυρσ	noun-fem-η
απότακτος	αποτακτ	adj-ος
απόφαση	αποφασ	noun-fem-η
απώλεια	απωλει	noun-fem-α
αργά	αργά	adv
αργοπορώ	αργοπορ	verb-b2
αργυρόδετο	αργυρόδετο	adj
αργώ	αργ	verb-b2
αριθμητικός	αριθμητικ	adj-ός
αριθμός	αριθμο	noun-neut-ι
αριστερά	αριστερά	adv
αριστοκρατία	αριστοκρατι	noun-fem-α
αρκετά	αρκετά	adv
αρκετός	αρκετ	adj-ός
αρκώ	αρκ	verb-b2
αρμοδιότητα	αρμοδιοτητ	noun-fem-α
αρμονικά	αρμονικά	adv
αρμόδιος	αρμοδι	adj-ος
αρνητικός	αρνητικ	adj-ός
αρνιέμαι	αρν	verb-
αρρώστια	αρρωστι	noun-fem-α
αρχή	αρχ	noun-fem-η
αρχίζω	αρχι	verb-a
αρχαίος	αρχαι	adj-ος
αρχαιολογικός	αρχαιολογικ	adj-ός
αρχαιότητα	αρχαιοτητ	noun-fem-α
αρχηγός	αρχηγο	noun-neut-ι
αρχικά	αρχικά	adv
αρχικός	αρχικ	adj-ός
αρχοντικό	αρχοντικ	noun-neut-ο
αρχοντικός	αρχοντικ	noun-neut-ι
ας	ας	aux
ασέληνος	ασέληνος	propn
ασαφής	ασαφ	adj-ής
ασθένεια	ασθενει	noun-fem-α
ασθενής	ασθεν	adj-ής
ασιατικός	ασιατικ	adj-ός
ασκώ	ασκ	verb-b2
αστικός	αστικ	adj-ός
αστυνομία	αστυνομια	noun-fem-α
αστυνομικός	αστυνομικ	noun-neut-ι
αστυνόμευση	αστυνομευσ	noun-fem-η
ασυλία	ασυλια	noun-fem-α
ασυνήθιστος	ασυνηθιστ	adj-ος
ασφάλεια	ασφαλεια	noun-fem-α
ασφάλιση	ασφαλισ	noun-fem-η
ασφαλής	ασφαλ	adj-ής
ασφαλώς	ασφαλώς	adv
ασχολούμαι	ασχολ	verb-
ατελώς	ατελώς	adv
ατζέντα	ατζεντ	noun-fem-α
ατμοσφαιρικός	ατμοσφαιρικ	adj-ός
ατμόσφαιρα	ατμοσφαιρ	noun-fem-α
ατομικά	ατομικά	adj
ατομικός	ατομικ	adj-ός
ατύχημα	ατυχη	noun-neut-μα
αυγή	αυγ	noun-fem-η
αυθόρμητος	αυθορμητ	adj-ος
αυξάνω	αυξαν	verb-a
αυξανόμενος	αυξανομενο	adj-ος
αυξημένος	αυξημεν	verb-
αυστηρά	αυστηρά	adv
αυστηρός	αυστηρο	adj-ός
αυστηρότητα	αυστηροτητα	noun-fem-α
αυταρχικός	αυταρχικ	adj-ός
αυτοαπασχολούμαι	αυτοαπασχολου	verb-
αυτοαπασχολούμενος	αυτοαπασχολουμεν	verb-
αυτοβούλως	αυτοβούλως	adv
αυτοδιάθεση	αυτοδιαθεσ	noun-fem-η
αυτοδιοίκηση	αυτοδιοικησ	noun-fem-η
αυτοκίνητο	αυτοκινητ	noun-neut-ο
αυτοκινητικός	αυτοκινητικ	adj-ός
αυτοκινητιστικός	αυτοκινητιστικ	adj-ός
αυτοκινητοβιομηχανία	αυτοκινητοβιομηχανι	noun-fem-α
αυτοκρατορία	αυτοκρατορια	noun-fem-α
αυτοκρατορικός	αυτοκρατορικ	adj-ός
αυτοκτονία	αυτοκτονι	noun-fem-α
αυτοκτονώ	αυτοκτον	verb-b2
αυτοματοποιημένος	αυτοματοποιημεν	adj-ος
αυτονομία	αυτονομι	noun-fem-α
αυτονόμηση	αυτονομησ	noun-fem-η
αυτοσκοπός	αυτοσκοπ	noun-neut-ι
αυτοσυγκράτηση	αυτοσυγκρατησ	noun-fem-η
αυτόματα	αυτόματα	adv
αυτόματος	αυτοματ	adj-ος
αυτόνομος	αυτονομ	adj-ος
αυτόπτης	αυτοπτ	adj-ης
αυτός	αυτός	det
αυτόχειρας	αυτοχειρ	noun-masc-ας
αφέντης	αφεντ	noun-masc-ης
αφήνω	αφην	verb-a
αφαιρώ	αφαιρ	verb-b2
αφγανικός	αφγανικ	adj-ός
αφενός	αφενός	adv
αφετέρου	αφετέρου	adv
αφηρημένα	αφηρημένα	adv
αφιερώνω	αφιερω	verb-a
αφομοίωση	αφομοιωσ	noun-fem-η
αφορίζω	αφοριζ	verb-a
αφορμή	αφορμ	noun-fem-η
αφορώ	αφορ	verb-b2
αφού	αφού	sconj
αφρικάνικος	αφρικανικ	adj-ος
αύξηση	αυξησ	noun-fem-η
αύριο	αύριο	adv
βάδισμα	βαδισ	noun-neut-μα
βάζω	βαζ	verb-a
βάθος	βαθ	noun-masc-ος
βάρκα	βαρκ	noun-fem-α
βάρος	βαρ	noun-masc-ος
βάσει	βασει	noun-neut-ι
βάση	βασ	noun-fem-η
βάσιμος	βασιμ	adj-ος
βέβαια	βέβαια	adv
βέβαιος	βεβαι	adj-ος
βέλτιστος	βελτιστ	adj-ος
βήμα	βημα	noun-neut-μα
βία	βι	noun-fem-α
βίαιος	βιαι	adj-ος
βίβλος	βιβλ	noun-masc-ος
βίδρα	βιδρ	noun-fem-α
βίζα	βιζ	noun-fem-α
βίος	βι	noun-masc-ος
βαθμός	βαθμ	noun-neut-ι
βαθύς	βαθ	adj-ύς
βαλκανικός	βαλκανικ	adj-ός
βαραίνω	βαραιν	verb-a
βαρβαρικός	βαρβαρικ	adj-ός
βαρόμετρο	βαρομετρ	noun-neut-ο
βαρύς	βαρυ	adj-ύς
βασίζω	βασι	verb-a
βασίλειο	βασιλειο	noun-neut-ο
βασίλισσα	βασιλισσ	noun-fem-α
βασανίζω	βασανιζ	verb-a
βασιζόμενος	βασιζομεν	adj-ος
βασικά	βασικά	adv
βασικός	βασικ	adj-ός
βασιλιάς	βασιλιάς	noun
βασιλικός	βασιλικ	adj-ός
βασιλομήτωρ	βασιλομήτωρ	noun
βατερλό	βατερλ	noun-neut-ο
βγαίνω	βγαιν	verb-a
βεβαίωση	βεβαιωσ	noun-fem-η
βεβαιότητα	βεβαιοτητ	noun-fem-α
βελγικός	βελγικ	adj-ός
βεληνεκές	βεληνεκές	noun
βελτίωση	βελτιωσ	noun-fem-η
βελτιώνω	βελτιω	verb-a
βενετσιάνικος	βενετσιανικ	adj-ος
βενζόλιο	βενζολ	noun-neut-ο
βερνίκι	βερνικι	noun-neut-ι
βιβλικός	βιβλικ	adj-ός
βιολογικός	βιολογικ	adj-ός
βιομηχανικός	βιομηχανικ	adj-ός
βιοτεχνία	βιοτεχνι	noun-fem-α
βιοτικός	βιοτικ	adj-ός
βιότοπος	βιοτοπ	noun-masc-ος
βιώσιμος	βιωσιμ	adj-ος
βλάβη	βλαβ	noun-fem-η
βλάπτω	βλαπτ	verb-a
βλέπω	βλεπ	verb-a
βλακώδης	βλακωδ	adj-ης
βοήθεια	βοηθεια	noun-fem-α
βοηθός	βοηθ	noun-neut-ι
βοηθώ	βοηθ	verb-b2
βομβαρδισμός	βομβαρδισμο	noun-neut-ι
βορειοανατολικός	βορειοανατολικ	adj-ός
βορειοκορεατικός	βορειοκορεατικ	adj-ός
βορράς	βορράς	noun
βουλή	βουλη	noun-fem-η
βουλγάρικος	βουλγαρικ	adj-ος
βουλευτής	βουλευτ	noun-masc-ης
βουλευτικός	βουλευτικ	adj-ός
βουνό	βουν	noun-neut-ο
βούλευμα	βουλευ	noun-neut-μα
βούληση	βουληση	noun-fem-η
βράδυ	βράδυ	noun
βράχος	βραχο	noun-masc-ος
βρέφος	βρεφ	noun-masc-ος
βρίσκω	βρισκ	verb-a
βραχονησίδα	βραχονησιδ	noun-fem-α
βραχυπρόθεσμος	βραχυπροθεσμ	adj-ος
βρετανικός	βρετανικ	adj-ός
βρετανός	βρεταν	adj-ός
βυζαντινός	βυζαντιν	adj-ός
βυθίζω	βυθιζ	verb-a
βωμός	βωμ	noun-neut-ι
βόρεια	βόρεια	adv
βόρειος	βορει	adj-ος
γάλλος	γάλλος	propn
γέφυρα	γεφυρα	noun-fem-α
γίνομαι	γιν	verb-παθ
γαλάζιος	γαλαζι	noun-masc-ος
γαληνότατος	γαληνοτατ	adj-ος
γαλλικός	γαλλικ	adj-ός
γείτονας	γειτον	noun-masc-ας
γεγονός	γεγονο	noun-neut-ι
γειτονιά	γειτονιά	noun
γειτονικός	γειτονικ	adj-ός
γεμίζω	γεμι	verb-a
γενετικός	γενετικ	adj-ός
γενιά	γενιά	noun
γενικά	γενικά	adv
γενικεύω	γενικευ	verb-a
γενικός	γενικ	adj-ός
γεννώ	γενν	verb-b2
γεράκι	γερακι	noun-neut-ι
γερακίνα	γερακιν	noun-fem-α
γερμανικός	γερμανικ	adj-ός
γερμανόφιλος	γερμανοφιλ	adj-ος
γερουσία	γερουσια	noun-fem-α
γερουσιαστής	γερουσιαστ	noun-masc-ης
γεφυρώνω	γεφυρω	verb-a
γεωγραφικός	γεωγραφικ	adj-ός
γεωργικός	γεωργικ	adj-ός
γη	γ	noun-fem-η
γηγενής	γηγεν	adj-ής
για	για	adp
γιατί	γιατί	adv
γιατρός	γιατρ	noun-neut-ι
γιγαντιαίος	γιγαντιαι	adj-ος
γιορτάζω	γιορταζ	verb-a
γιος	γι	noun-masc-ος
γιουγκοσλαβικός	γιουγκοσλαβικ	adj-ός
γιό	γ	noun-neut-ο
γιός	γι	noun-neut-ι
γκρεμός	γκρεμο	noun-neut-ι
γλιτώνω	γλιτων	verb-a
γλωσσικός	γλωσσικ	adj-ός
γλώσσα	γλωσσ	noun-fem-α
γνήσιος	γνησι	adj-ος
γνωμοδότηση	γνωμοδοτησ	noun-fem-η
γνωρίζω	γνωρι	verb-a
γνωστός	γνωστ	adj-ός
γνώμη	γνωμη	noun-fem-η
γνώρισμα	γνωρισ	noun-neut-μα
γνώσει	γνωσει	noun-neut-ι
γνώση	γνωσ	noun-fem-η
γοητευτικός	γοητευτικ	adj-ός
γονέων	γονέων	noun
γράμμα	γραμ	noun-neut-μα
γράφω	γραφ	verb-a
γρήγορος	γρηγορ	adj-ος
γρίπη	γριπη	noun-fem-η
γραμμή	γραμμ	noun-fem-η
γραμματέας	γραμματεα	noun-masc-ας
γραπτός	γραπτ	adj-ός
γραφείο	γραφει	noun-neut-ο
γραφειοκρατία	γραφειοκρατι	noun-fem-α
γραφειοκρατικός	γραφειοκρατικ	adj-ός
γραφικός	γραφικ	adj-ός
γυμνάσιο	γυμνασ	noun-neut-ο
γυναίκα	γυναικ	noun-fem-α
γυρίζω	γυρι	verb-a
γύρος	γυρ	noun-masc-ος
γύρω	γύρω	adv
δάσκαλος	δασκαλ	noun-masc-ος
δάσος	δασ	noun-masc-ος
δέκα	δέκα	num
δέκατος	δεκατ	adj-ος
δέντρο	δεντρ	noun-neut-ο
δέσμευση	δεσμευσ	noun-fem-η
δέσμη	δεσμη	noun-fem-η
δέχομαι	δεχ	verb-παθ
δήλωση	δηλωσ	noun-fem-η
δήμος	δημ	noun-masc-ος
δίκαιο	δικαι	noun-neut-ο
δίκη	δικη	noun-fem-η
δίκιο	δικ	noun-neut-ο
δίκτυο	δικτυ	noun-neut-ο
δίλημμα	διλημ	noun-neut-μα
δίμηνος	διμην	adj-ος
δίνω	διν	verb-a
δίπλωμα	διπλω	noun-neut-μα
δίσκος	δισκ	noun-masc-ος
δίχως	δίχως	adp
δίωξη	διωξ	noun-fem-η
δανείζω	δανειζ	verb-a
δαπάνη	δαπαν	noun-fem-η
δαπανώ	δαπαν	verb-b2
δε	δε	adv
δείγμα	δειγ	noun-neut-μα
δείκτης	δεικτ	noun-masc-ης
δείχνω	δειχν	verb-a
δεδομένο	δεδομένο	adv
δεκάδα	δεκάδα	num
δεκαεννέα	δεκαεννέα	num
δεκαετής	δεκαετ	adj-ής
δεκαετία	δεκαετι	noun-fem-α
δεκαπέντε	δεκαπέντε	num
δεκτός	δεκτ	adj-ός
δεν	δεν	part
δεξαμενή	δεξαμεν	noun-fem-η
δεξιά	δεξιά	noun
δεξιός	δεξι	noun-neut-ι
δεξιόστροφος	δεξιοστροφ	adj-ος
δεσμευτικός	δεσμευτικ	adj-ός
δεσμεύω	δεσμευ	verb-a
δεσμοφύλακας	δεσμοφυλακ	noun-masc-ας
δεσμός	δεσμ	noun-neut-ι
δευτεροβάθμιος	δευτεροβαθμι	adj-ος
δευτερόλεπτο	δευτερολεπτ	noun-neut-ο
δεύτερος	δευτερ	adj-ος
δηλαδή	δηλαδή	adv
δηλώνω	δηλω	verb-a
δημιουργία	δημιουργια	noun-fem-α
δημιουργώ	δημιουργ	verb-b2
δημιούργημα	δημιουργη	noun-neut-μα
δημοκρατία	δημοκρατι	noun-fem-α
δημοκρατικά	δημοκρατικά	adv
δημοκρατικός	δημοκρατικ	adj-ός
δημοσίευμα	δημοσιευ	noun-neut-μα
δημοσίου/ιδιωτικού	δημοσίου/ιδιωτικού	adj
δημοσιεύω	δημοσιευ	verb-a
δημοσιογράφος	δημοσιογραφ	noun-masc-ος
δημοσιονομικός	δημοσιονομικ	adj-ός
δημοσιοποιώ	δημοσιοποι	verb-b2
δημοσιότητα	δημοσιοτητ	noun-fem-α
δημοσκόπηση	δημοσκοπησ	noun-fem-η
δημοτικότητα	δημοτικοτητ	noun-fem-α
δημοφιλής	δημοφιλ	adj-ής
δημοψήφισμα	δημοψηφισ	noun-neut-μα
δημόσιος	δημοσι	adj-ος
διάβα	διαβ	noun-fem-α
διάβημα	διαβη	noun-neut-μα
διάβολος	διαβολ	noun-masc-ος
διάδοση	διαδοσ	noun-fem-η
διάδοχος	διαδοχο	noun-masc-ος
διάθεση	διαθεση	noun-fem-η
διάκριση	διακρισ	noun-fem-η
διάλογος	διαλογο	noun-masc-ος
διάλυση	διαλυσ	noun-fem-η
διάρκεια	διαρκεια	noun-fem-α
διάσκεψη	διασκεψ	noun-fem-η
διάσπαρτος	διασπαρτ	adj-ος
διάσταση	διαστασ	noun-fem-η
διάστημα	διαστημα	noun-neut-μα
διάσωση	διασωση	noun-fem-η
διάταξη	διαταξ	noun-fem-η
διάφορος	διαφορ	adj-ος
διάχυτος	διαχυτ	adj-ος
διέρχομαι	διερχ	verb-παθ
διίσταμαι	διιστ	verb-
δια	δια	adp
διαβάζω	διαβαζ	verb-a
διαβιβάζω	διαβιβα	verb-a
διαβιβαστικός	διαβιβαστικ	adj-ός
διαβουλεύω	διαβουλευ	verb-a
διαβούλευση	διαβουλευσ	noun-fem-η
διαγραφή	διαγραφ	noun-fem-η
διαγωγή	διαγωγη	noun-fem-η
διαγωνισμός	διαγωνισμο	noun-neut-ι
διαδέχομαι	διαδεχ	verb-παθ
διαδήλωση	διαδηλωσ	noun-fem-η
διαδίκτυο	διαδικτυο	noun-neut-ο
διαδηλωτής	διαδηλωτ	noun-masc-ης
διαδηλώνω	διαδηλων	verb-a
διαδικασία	διαδικασι	noun-fem-α
διαδραματίζω	διαδραματι	verb-a
διαδρομή	διαδρομ	noun-fem-η
διαθέσιμος	διαθεσιμ	adj-ος
διαθέτω	διαθετ	verb-a
διαθεσιμότητα	διαθεσιμοτητ	noun-fem-α
διακήρυξη	διακηρυξη	noun-fem-η
διακανονισμός	διακανονισμ	noun-neut-ι
διακηρύσσω	διακηρυ	verb-a
διακινδυνεύω	διακινδυνευ	verb-a
διακοίνωση	διακοινωσ	noun-fem-η
διακοπή	διακοπ	noun-fem-η
διακρίνω	διακριν	verb-a
διακρατικός	διακρατικ	adj-ός
διακριτικός	διακριτικ	adj-ός
διακριτικότητα	διακριτικοτητ	noun-fem-α
διακυβέρνηση	διακυβερνησ	noun-fem-η
διακυβερνητικός	διακυβερνητικ	adj-ός
διακόπτω	διακοπτ	verb-a
διαλυτικό	διαλυτικ	noun-neut-ο
διαμάχη	διαμαχ	noun-fem-η
διαμαρτυρία	διαμαρτυρια	noun-fem-α
διαμαρτυρώ	διαμαρτυρ	verb-b2
διαμαρτύρομαι	διαμαρτυρ	verb-παθ
διαμορφώνω	διαμορφων	verb-a
διανέμω	διανεμ	verb-a
διανομή	διανομ	noun-fem-η
διανύω	διανυ	verb-a
διαπίστευση	διαπιστευσ	noun-fem-η
διαπιστευτήριο	διαπιστευτηρ	noun-neut-ο
διαπιστώνω	διαπιστω	verb-a
διαπνέω	διαπν	verb-b1
διαπράττω	διαπρα	verb-a
διαπραγμάτευση	διαπραγματευσ	noun-fem-η
διαπραγματεύομαι	διαπραγματευ	verb-παθ
διαρκώ	διαρκ	verb-b2
διαρκώς	διαρκώς	adv
διαρρέω	διαρρε	verb-b1
διαρροή	διαρρο	noun-fem-η
διασημότητα	διασημοτητ	noun-fem-α
διασπορά	διασπορά	noun
διασυνοριακός	διασυνοριακ	adj-ός
διασφάλιση	διασφαλισ	noun-fem-η
διασφαλίζω	διασφαλι	verb-a
διασχίζω	διασχιζ	verb-a
διασωστικός	διασωστικ	adj-ός
διασώζω	διασωζ	verb-a
διατήρηση	διατηρησ	noun-fem-η
διαταραχή	διαταραχ	noun-fem-η
διατεθειμένος	διατεθειμεν	adj-ος
διατηρητέος	διατηρητε	adj-ος
διατηρώ	διατηρ	verb-b2
διατρανώνω	διατρανων	verb-a
διατυπώνω	διατυπω	verb-a
διατύπωση	διατυπωσ	noun-fem-η
διαφάνεια	διαφανει	noun-fem-α
διαφέρω	διαφερ	verb-a
διαφανής	διαφανη	adj-ής
διαφεύγω	διαφευγ	verb-a
διαφθορά	διαφθορά	noun
διαφιλονικούμενος	διαφιλονικουμεν	adj-ος
διαφορά	διαφορά	noun
διαφορετικά	διαφορετικά	adv
διαφορετικός	διαφορετικ	adj-ός
διαφοροποιώ	διαφοροποι	verb-b2
διαφωνία	διαφωνι	noun-fem-α
διαφωνώ	διαφων	verb-b2
διαχείριση	διαχειριση	noun-fem-η
διαχωρισμός	διαχωρισμο	noun-neut-ι
διδάσκω	διδασκ	verb-a
διδάσκων	διδάσκων	noun
διδασκόμενος	διδασκομεν	noun-masc-ος
διείσδυση	διεισδυσ	noun-fem-η
διεθνής	διεθν	adj-ής
διεθνώς	διεθνώς	adv
διεκδικώ	διεκδικ	verb-b2
διεκπεραίωση	διεκπεραιωσ	noun-fem-η
διενέργεια	διενεργει	noun-fem-α
διεξάγω	διεξ	verb-a
διεξαγωγή	διεξαγωγη	noun-fem-η
διερευνώ	διερευν	verb-b2
διερεύνηση	διερευνηση	noun-fem-η
διερχόμενος	διερχομεν	adj-ος
διετής	διετ	adj-ής
διετία	διετι	noun-fem-α
διευθέτηση	διευθετησ	noun-fem-η
διευθυντής	διευθυντ	noun-masc-ης
διευθύντρια	διευθυντρι	noun-fem-α
διευκολύνω	διευκολυν	verb-a
διευκρινίζω	διευκρινι	verb-a
διευκόλυνση	διευκολυνσ	noun-fem-η
διεύθυνση	διευθυνσ	noun-fem-η
διεύρυνση	διευρυνση	noun-fem-η
δικαίωμα	δικαιωμα	noun-neut-μα
δικαιολογία	δικαιολογι	noun-fem-α
δικαιολογημένος	δικαιολογημεν	adj-ος
δικαιολογώ	δικαιολογώ	adv
δικαιοσύνη	δικαιοσυνη	noun-fem-η
δικαστήριο	δικαστηριο	noun-neut-ο
δικαστής	δικαστ	noun-masc-ης
δικαστικός	δικαστικ	adj-ός
δικηγόρος	δικηγορ	noun-masc-ος
δικός	δικ	adj-ός
διμερής	διμερ	adj-ής
διοίκηση	διοικησ	noun-fem-η
διοικητήριο	διοικητηρ	noun-neut-ο
διοικητής	διοικητ	noun-masc-ης
διοικητικός	διοικητικ	adj-ός
διοξείδιο	διοξειδ	noun-neut-ο
διορίζω	διοριζ	verb-a
διοργανική	διοργανική	adj
διοργανικός	διοργανικ	adj-ός
διοργανώνω	διοργανων	verb-a
διορισμός	διορισμο	noun-neut-ι
διπλάσιος	διπλασι	adj-ος
διπλασιάζω	διπλασιαζ	verb-a
διπλωματία	διπλωματια	noun-fem-α
διπλωματικός	διπλωματικ	adj-ός
διπλός	διπλ	adj-ός
δισεκατομμύριο	δισεκατομμυρι	noun-neut-ο
διχλωροβενζόλιο	διχλωροβενζολ	noun-neut-ο
διότι	διότι	sconj
διώχνω	διωχν	verb-a
δοκιμάζω	δοκιμαζ	verb-a
δοκιμή	δοκιμ	noun-fem-η
δολάριο	δολαρι	noun-neut-ο
δολοφονία	δολοφονι	noun-fem-α
δολοφονικός	δολοφονικ	adj-ός
δομή	δομ	noun-fem-η
δομώ	δομ	verb-b2
δουλειά	δουλειά	noun
δουλεύω	δουλευ	verb-a
δράση	δρασ	noun-fem-η
δράστης	δραστ	noun-masc-ης
δράττω	δραττ	verb-a
δρέπανο	δρεπαν	noun-neut-ο
δραστήρια	δραστήρια	adv
δραστηριοποιούμενος	δραστηριοποιουμεν	adj-ος
δραστηριοποιώ	δραστηριοποι	verb-b2
δραστηριότητα	δραστηριοτητ	noun-fem-α
δραστικά	δραστικά	adv
δραστικός	δραστικ	adj-ός
δραχμή	δραχμ	noun-fem-η
δρεπάνι	δρεπανι	noun-neut-ι
δριμύς	δριμυ	adj-ύς
δρομολογώ	δρομολογ	verb-b2
δρομολόγηση	δρομολογηση	noun-fem-η
δρομολόγιο	δρομολογ	noun-neut-ο
δρυμείας	δρυμείας	adj
δρω	δρ	verb-a
δρόμος	δρομο	noun-masc-ος
δυναμικά	δυναμικά	adv
δυναμικός	δυναμικ	noun-neut-ι
δυναμώνω	δυναμων	verb-a
δυνατός	δυνατ	adj-ός
δυνατότητα	δυνατοτητ	noun-fem-α
δυνητικά	δυνητικά	adv
δυσκίνητος	δυσκινητ	adj-ος
δυσκολία	δυσκολι	noun-fem-α
δυστυχώς	δυστυχώς	adv
δυστύχημα	δυστυχη	noun-neut-μα
δυσφημίζω	δυσφημιζ	verb-a
δυσχερής	δυσχερ	adj-ής
δυτικά	δυτικά	adv
δυτικοαφρικανικός	δυτικοαφρικανικ	adj-ός
δυτικός	δυτικ	adj-ός
δυόμισι	δυόμισι	num
δωρεά	δωρεά	noun
δωρικός	δωρικ	adj-ός
δωροδοκία	δωροδοκι	noun-fem-α
δόγμα	δογ	noun-neut-μα
δόνηση	δονησ	noun-fem-η
δύναμη	δυναμ	noun-fem-η
δύο	δύο	num
δύση	δυση	noun-fem-η
δύσκολος	δυσκολ	adj-ος
εάν	εάν	sconj
είδηση	ειδησ	noun-fem-η
είδος	ειδ	noun-masc-ος
είκοσι	είκοσι	num
είμαι	είμαι	aux
είμαστε	είμαστε	aux
είναι	είναι	aux
είσοδος	εισοδο	noun-masc-ος
είσπραξη	εισπραξ	noun-fem-η
είτε	είτε	cconj
εαρινός	εαριν	adj-ός
εαυτός	εαυτ	noun-neut-ι
εβδομάδα	εβδομαδ	noun-fem-α
εβραϊκός	εβραικ	adj-ός
εγγενής	εγγεν	adj-ής
εγγυήτρια	εγγυήτρια	adj
εγγυώμαι	εγγυ	verb-παθ
εγγύηση	εγγυησ	noun-fem-η
εγγύτητα	εγγυτητ	noun-fem-α
εγκέφαλος	εγκεφαλ	noun-masc-ος
εγκαθίδρυση	εγκαθιδρυσ	noun-fem-η
εγκατάλειψη	εγκαταλειψ	noun-fem-η
εγκατάσταση	εγκαταστασ	noun-fem-η
εγκαταλείπω	εγκαταλει	verb-a
εγκεφαλικός	εγκεφαλικ	adj-ός
εγκληματικός	εγκληματικ	adj-ός
εγκρίνω	εγκριν	verb-a
εγκώμιο	εγκωμ	noun-neut-ο
εγχείρημα	εγχειρη	noun-neut-μα
εγωιστικά	εγωιστικά	adv
εγώ	εγώ	pron
εδραιώνω	εδραιων	verb-a
εδώ	εδώ	adv
εθελοντής	εθελοντ	noun-masc-ης
εθελοντικά	εθελοντικά	adv
εθελοντικός	εθελοντικ	adj-ός
εθνικός	εθνικ	adj-ός
εθνοσυνέλευση	εθνοσυνελευσ	noun-fem-η
εθνοφρουρός	εθνοφρουρ	noun-neut-ι
εθνότητα	εθνοτητ	noun-fem-α
ειδάλλως	ειδάλλως	adv
ειδησεογραφικός	ειδησεογραφικ	adj-ός
ειδικά	ειδικά	adv
ειδικός	ειδικ	adj-ός
ειδοποίηση	ειδοποιησ	noun-fem-η
ειδοποιώ	ειδοποι	verb-b2
εικοσαετία	εικοσαετι	noun-fem-α
εικόνα	εικον	noun-fem-α
ειλικρινά	ειλικρινά	adv
ειλικρινής	ειλικριν	adj-ής
ειρήνη	ειρηνη	noun-fem-η
ειρηνευτικός	ειρηνευτικ	adj-ός
ειρηνικά	ειρηνικά	adv
ειρωνικός	ειρωνικ	adj-ός
εις	εις	adp
εισάγω	εισαγ	verb-a
εισήγηση	εισηγησ	noun-fem-η
εισαγγελέας	εισαγγελε	noun-masc-ας
εισαγγελία	εισαγγελια	noun-fem-α
εισαγγελικός	εισαγγελικ	adj-ός
εισαγωγή	εισαγωγ	noun-fem-η
εισβάλλω	εισβαλλ	verb-a
εισβολέας	εισβολε	noun-masc-ας
εισβολή	εισβολη	noun-fem-η
εισηγήτρια	εισηγητρι	noun-fem-α
εισηγητής	εισηγητ	noun-masc-ης
εισπράττω	εισπραττ	verb-a
εισροή	εισρο	noun-fem-η
εισφορά	εισφορά	noun
εισόδημα	εισοδημα	noun-neut-μα
εκ	εκ	adp
εκάστοτε	εκάστοτε	adv
εκατομμύριο	εκατομμυρι	noun-neut-ο
εκατοντάδα	εκατοντάδα	num
εκατοστιαίος	εκατοστιαι	adj-ος
εκατό	εκατό	num
εκατόμβη	εκατομβ	noun-fem-η
εκβάλλω	εκβαλλ	verb-a
εκδήλωση	εκδηλωσ	noun-fem-η
εκδίδω	εκδιδ	verb-a
εκδηλώνω	εκδηλων	verb-a
εκδιώκω	εκδιωκ	verb-a
εκδοθείς	εκδοθείς	adj
εκδοχή	εκδοχ	noun-fem-η
εκεί	εκεί	adv
εκείνος	εκειν	pron-masc-ος
εκθέτω	εκθετ	verb-a
εκκένωση	εκκενωσ	noun-fem-η
εκκίνηση	εκκινησ	noun-fem-η
εκκλησάκι	εκκλησακι	noun-neut-ι
εκκλησία	εκκλησι	noun-fem-α
εκκλησιά	εκκλησιά	noun
εκκλησιαστικός	εκκλησιαστικ	adj-ός
εκκρεμώ	εκκρεμ	verb-b2
εκλέγω	εκλέγω	adj
εκλέκτορας	εκλεκτορ	noun-masc-ας
εκλείπω	εκλειπ	verb-a
εκλεγείς	εκλεγείς	adj
εκλεκτορικός	εκλεκτορικ	adj-ός
εκλογή	εκλογ	noun-fem-η
εκλογικός	εκλογικ	adj-ός
εκπέμπω	εκπεμπ	verb-a
εκπαίδευση	εκπαιδευση	noun-fem-η
εκπαιδευτικός	εκπαιδευτικ	adj-ός
εκπαιδεύω	εκπαιδευ	verb-a
εκπατρίζομαι	εκπατριζ	verb-παθ
εκπλήρωση	εκπληρωσ	noun-fem-η
εκπλήσσω	εκπλησσ	verb-a
εκπληρώνω	εκπληρω	verb-a
εκπομπή	εκπομπ	noun-fem-η
εκπονώ	εκπον	verb-b2
εκπροσωπώ	εκπροσωπ	verb-b2
εκπροσώπηση	εκπροσωπηση	noun-fem-η
εκπρόσωπος	εκπροσωπ	noun-masc-ος
εκρηκτικά	εκρηκτικά	noun
εκρηκτικός	εκρηκτικ	noun-neut-ι
εκσκαφέας	εκσκαφε	noun-masc-ας
εκστρατεία	εκστρατεια	noun-fem-α
εκσυγχρονισμός	εκσυγχρονισμ	noun-neut-ι
εκτέλεση	εκτελεση	noun-fem-η
εκτίμηση	εκτιμησ	noun-fem-η
εκτείνω	εκτειν	verb-a
εκτεθειμένος	εκτεθειμεν	adj-ος
εκτελεστικός	εκτελεστικ	adj-ός
εκτελεστός	εκτελεστ	noun-neut-ι
εκτελώ	εκτελ	verb-b2
εκτεταμένος	εκτεταμεν	adj-ος
εκτιμώ	εκτιμ	verb-b2
εκτοπίζω	εκτοπι	verb-a
εκτόνωση	εκτονωσ	noun-fem-η
εκτόξευση	εκτοξευσ	noun-fem-η
εκτός	εκτός	adv
εκφράζω	εκφραζ	verb-a
εκχωρώ	εκχωρ	verb-b2
ελάχιστος	ελαχιστ	adj-ος
ελέγχω	ελεγχ	verb-a
ελαφρά	ελαφρά	adv
ελαχιστοποίηση	ελαχιστοποιησ	noun-fem-η
ελεγκτής	ελεγκτ	noun-masc-ης
ελεγκτικός	ελεγκτικ	adj-ός
ελεγχόμενος	ελεγχομεν	adj-ος
ελευθέρωση	ελευθερωση	noun-fem-η
ελευθερία	ελευθερι	noun-fem-α
ελεύθερα	ελεύθερα	adv
ελεύθερος	ελευθερ	adj-ος
ελκύω	ελκυ	verb-a
ελληνικός	ελληνικ	adj-ός
ελληνοκυπριακός	ελληνοκυπριακ	adj-ός
ελληνοτουρκικός	ελληνοτουρκικ	adj-ός
ελληνόφωνος	ελληνοφων	adj-ος
ελπίδα	ελπιδ	noun-fem-α
ελπίζω	ελπιζ	verb-a
εμβέλεια	εμβελει	noun-fem-α
εμβολιάζω	εμβολιαζ	verb-a
εμβολιασμός	εμβολιασμ	noun-neut-ι
εμβολιαστικός	εμβολιαστικ	adj-ός
εμβόλιο	εμβολι	noun-neut-ο
εμμένω	εμμεν	verb-a
εμμονή	εμμον	noun-fem-η
εμπαιγμός	εμπαιγμ	noun-neut-ι
εμπειρία	εμπειρι	noun-fem-α
εμπειρογνωμοσύνη	εμπειρογνωμοσυν	noun-fem-η
εμπειρογνώμονας	εμπειρογνωμον	noun-masc-ας
εμπιστοσύνη	εμπιστοσυνη	noun-fem-η
εμπλέκω	εμπλεκ	verb-a
εμποδίζω	εμποδιζ	verb-a
εμπορευματικός	εμπορευματικ	adj-ός
εμπορικός	εμπορικ	adj-ός
εμπρός	εμπρός	adv
εμπόδιο	εμποδι	noun-neut-ο
εμπόλεμος	εμπολεμ	adj-ος
εμπόριο	εμποριο	noun-neut-ο
εμφάνιση	εμφανισ	noun-fem-η
εμφανής	εμφαν	adj-ής
εμφανίζω	εμφανι	verb-a
εν	εν	adp
ενάμισης	ενάμισης	num
ενάντια	ενάντια	adv
ενέργεια	ενεργει	noun-fem-α
ενίσταμαι	ενιστ	verb-
ενίσχυση	ενισχυσ	noun-fem-η
εναέριος	εναερι	adj-ος
εναλλακτικός	εναλλακτικ	adj-ός
εναλλασσόμενος	εναλλασσομεν	adj-ος
εναντίον	εναντίον	adp
εναντιώνομαι	εναντιων	verb-παθ
εναποθέτω	εναποθετ	verb-a
εναπομείνας	εναπομείνας	adj
εναρμόνιση	εναρμονισ	noun-fem-η
ενδέχεται	ενδεχεται	verb-παθ
ενδείκνυμαι	ενδε	verb-
ενδεχομένως	ενδεχομένως	adv
ενδεχόμενο	ενδεχομεν	noun-neut-ο
ενδιάμεσος	ενδιαμεσ	adj-ος
ενδιαφέρον	ενδιαφέρον	noun
ενδιαφέρω	ενδιαφερ	verb-a
ενδιαφέρων	ενδιαφέρων	adj
ενδυναμώνω	ενδυναμων	verb-a
ενεργά	ενεργά	adv
ενεργειακός	ενεργειακ	adj-ός
ενεργός	ενεργο	adj-ός
ενεργώ	ενεργ	verb-b2
ενημέρωση	ενημερωσ	noun-fem-η
ενημερώνω	ενημερω	verb-a
ενθαρρυντικός	ενθαρρυντικ	adj-ός
ενθαρρύνω	ενθαρρυν	verb-a
ενθουσιασμός	ενθουσιασμ	noun-neut-ι
ενθρονίζω	ενθρονιζ	verb-a
ενιαίος	ενιαι	adj-ος
ενισχύω	ενισχυ	verb-a
ενλόγω	ενλόγω	adj
εννέα	εννέα	num
εννεάμηνος	εννεαμην	noun-masc-ος
εννοώ	εννο	verb-b2
ενοικιάζω	ενοικιαζ	verb-a
ενοποίηση	ενοποιησ	noun-fem-η
ενοποιώ	ενοποι	verb-b2
ενσταλάζω	ενσταλαζ	verb-a
ενσωμάτωση	ενσωματωση	noun-fem-η
ενσωματώνω	ενσωματω	verb-a
εντάξει	εντάξει	adv
εντάσσω	εντα	verb-a
εντατικοποίηση	εντατικοποιησ	noun-fem-η
εντατικοποιώ	εντατικοποι	verb-b2
εντατικός	εντατικ	adj-ός
εντείνω	εντειν	verb-a
εντελώς	εντελώς	adv
εντολή	εντολη	noun-fem-η
εντοπίζω	εντοπι	verb-a
εντοπισμός	εντοπισμ	noun-neut-ι
εντούτοις	εντούτοις	adv
εντυπωσιακός	εντυπωσιακ	adj-ός
εντός	εντός	adv
εντύπωση	εντυπωση	noun-fem-η
ενότητα	ενοτητα	noun-fem-α
ενόψει	ενόψει	adp
ενώ	ενώ	sconj
ενώνω	ενων	verb-a
ενώπιον	ενώπιον	adp
εξ	εξ	adp
εξάγω	εξαγ	verb-a
εξάλειψη	εξαλειψη	noun-fem-η
εξάλλου	εξάλλου	adv
εξάμηνος	εξαμην	adj-ος
εξάπλωση	εξαπλωσ	noun-fem-η
εξάρθρωση	εξαρθρωσ	noun-fem-η
εξάρτηση	εξαρτησ	noun-fem-η
εξέγερση	εξεγερσ	noun-fem-η
εξέλιξη	εξελιξ	noun-fem-η
εξέταση	εξετασ	noun-fem-η
εξέχων	εξέχων	adj
εξήντα	εξήντα	num
εξής	εξής	adv
εξίσου	εξίσου	adv
εξαίρεση	εξαιρεση	noun-fem-η
εξαίρετος	εξαιρετ	adj-ος
εξαγγέλλω	εξαγγελλ	verb-a
εξαγορά	εξαγορά	noun
εξαγωγικός	εξαγωγικ	adj-ός
εξαιρετικά	εξαιρετικά	adv
εξαιρετικός	εξαιρετικ	adj-ός
εξαιρώ	εξαιρ	verb-b2
εξαιτίας	εξαιτίας	adp
εξακολουθώ	εξακολουθ	verb-b2
εξακριβώνω	εξακριβω	verb-a
εξαμηνιαίος	εξαμηνιαι	adj-ος
εξαναγκάζω	εξαναγκαζ	verb-a
εξανεμίζω	εξανεμιζ	verb-a
εξαντλώ	εξαντλ	verb-b2
εξαπολύω	εξαπολυ	verb-a
εξαρτώ	εξαρτ	verb-b2
εξαρχία	εξαρχι	noun-fem-α
εξασφαλίζω	εξασφαλι	verb-a
εξεγερμένος	εξεγερμεν	adj-ος
εξειδίκευση	εξειδικευσ	noun-fem-η
εξελίσσω	εξελισσ	verb-a
εξετάζω	εξετα	verb-a
εξηγώ	εξηγ	verb-b2
εξολοκλήρου	εξολοκλήρου	adv
εξοπλισμός	εξοπλισμ	noun-neut-ι
εξουσία	εξουσι	noun-fem-α
εξουσιάζω	εξουσιαζ	verb-a
εξουσιοδοτώ	εξουσιοδοτ	verb-b2
εξτρεμιστής	εξτρεμιστ	noun-masc-ης
εξυπηρετώ	εξυπηρετ	verb-b2
εξωθώ	εξωθ	verb-b2
εξωτερικά	εξωτερικά	noun
εξωτερικό	εξωτερικ	noun-neut-ο
εξωτερικός	εξωτερικ	adj-ός
εξόριστος	εξοριστ	adj-ος
εξόρυξη	εξορυξη	noun-fem-η
επέκταση	επεκτασ	noun-fem-η
επέμβαση	επεμβασ	noun-fem-η
επένδυση	επενδυσ	noun-fem-η
επί	επί	adp
επίγνωση	επιγνωσ	noun-fem-η
επίδοση	επιδοσ	noun-fem-η
επίδραση	επιδρασ	noun-fem-η
επίθεση	επιθεσ	noun-fem-η
επίκαιρος	επικαιρ	adj-ος
επίκεντρο	επικεντρ	noun-neut-ο
επίκριση	επικρισ	noun-fem-η
επίλυση	επιλυσ	noun-fem-η
επίμαχος	επιμαχ	adj-ος
επίπεδο	επιπεδ	noun-neut-ο
επίπτωση	επιπτωσ	noun-fem-η
επίρριψη	επιρριψ	noun-fem-η
επίσημα	επίσημα	adv
επίσημος	επισημ	adj-ος
επίσης	επίσης	adv
επίσκεψη	επισκεψη	noun-fem-η
επίσκοπος	επισκοπ	noun-masc-ος
επίτευγμα	επιτευγμα	noun-neut-μα
επίτευξη	επιτευξη	noun-fem-η
επίτροπος	επιτροπ	noun-masc-ος
επαγγελματίας	επαγγελματίας	adj
επαγγελματικός	επαγγελματικ	adj-ός
επανάληψη	επαναληψ	noun-fem-η
επανάσταση	επανασταση	noun-fem-η
επανέναρξη	επανεναρξ	noun-fem-η
επανένταξη	επανενταξ	noun-fem-η
επανέρχομαι	επαν	verb-παθ
επαναλαμβάνω	επαν	verb-a
επαναληπτικός	επαναληπτικ	adj-ός
επαναστάτης	επαναστατ	noun-masc-ης
επαναστατικός	επαναστατικ	adj-ός
επανασύνδεση	επανασυνδεσ	noun-fem-η
επαναφέρω	επαν	verb-a
επανειλημμένα	επανειλημμένα	adv
επανεκλογή	επανεκλογ	noun-fem-η
επανεξετάζω	επανεξετα	verb-a
επαρκής	επαρκ	adj-ής
επαρκώς	επαρκώς	adv
επαρχία	επαρχι	noun-fem-α
επαφή	επαφ	noun-fem-η
επαχθής	επαχθ	adj-ής
επείγων	επείγων	adj
επειγόντως	επειγόντως	adv
επειδή	επειδή	sconj
επεισόδιο	επεισοδ	noun-neut-ο
επεκτείνω	επεκτ	verb-a
επεμβαίνω	επεμβαιν	verb-a
επεξεργάζομαι	επεξεργα	verb-παθ
επεξεργασία	επεξεργασι	noun-fem-α
επερχόμενος	επερχομεν	adj-ος
επηρεάζω	επηρεα	verb-a
επιβάλλω	επιβ	verb-a
επιβάρυνση	επιβαρυνσ	noun-fem-η
επιβάτης	επιβατ	noun-masc-ης
επιβαρύνω	επιβαρυν	verb-a
επιβατικός	επιβατικ	adj-ός
επιβεβαιώνω	επιβεβαιω	verb-a
επιβλητικός	επιβλητικ	adj-ός
επιβολή	επιβολη	noun-fem-η
επιδέχομαι	επιδεχ	verb-παθ
επιδίδω	επιδιδ	verb-a
επιδείνωση	επιδεινωσ	noun-fem-η
επιδεικνύω	επιδεικνυ	verb-a
επιδεινώνω	επιδεινων	verb-a
επιδημία	επιδημια	noun-fem-α
επιδημιολογία	επιδημιολογι	noun-fem-α
επιδιώκουν	επιδιωκουν	verb-
επιδιώκω	επιδιω	verb-a
επιδοκιμάζω	επιδοκιμαζ	verb-a
επιδρομή	επιδρομ	noun-fem-η
επιδότηση	επιδοτησ	noun-fem-η
επιθετικός	επιθετικ	adj-ός
επιθεώρηση	επιθεωρησ	noun-fem-η
επιθυμία	επιθυμι	noun-fem-α
επιθυμώ	επιθυμ	verb-b2
επικίνδυνα	επικίνδυνα	adv
επικίνδυνος	επικινδυν	adj-ος
επικαιρότητα	επικαιροτητ	noun-fem-α
επικαλούμενος	επικαλουμεν	adj-ος
επικείμενος	επικειμεν	adj-ος
επικεντρώνω	επικεντρω	verb-a
επικερδής	επικερδ	adj-ής
επικερδώς	επικερδώς	adv
επικεφαλής	επικεφαλ	adj-ής
επικοινωνία	επικοινωνι	noun-fem-α
επικοινωνιακός	επικοινωνιακ	adj-ός
επικοινωνώ	επικοινων	verb-b2
επικουρικότητα	επικουρικοτητα	noun-fem-α
επικρίνω	επικριν	verb-a
επικρατώ	επικρατ	verb-b2
επικροτώ	επικροτ	verb-b2
επιλέγω	επιλεγ	verb-a
επιλεκτικά	επιλεκτικά	adv
επιλεκτικός	επιλεκτικ	adj-ός
επιλογή	επιλογ	noun-fem-η
επιλύω	επιλυ	verb-a
επιμένω	επιμεν	verb-a
επιμονή	επιμον	noun-fem-η
επιμόρφωση	επιμορφωση	noun-fem-η
επιπλέον	επιπλέον	adv
επιπρόσθετα	επιπρόσθετα	adv
επιρρίπτω	επιρριπτ	verb-a
επιρροή	επιρρο	noun-fem-η
επισήμανση	επισημανσ	noun-fem-η
επισημαίνω	επισημαιν	verb-a
επισκέπτηκαν	επισκεπτηκαν	verb-
επισκέπτης	επισκεπτ	noun-masc-ης
επισκέπτομαι	επισκε	verb-παθ
επισκέψιμο	επισκεψιμ	noun-neut-ο
επισκευή	επισκευ	noun-fem-η
επισκευαστής	επισκευαστ	noun-masc-ης
επισκόπηση	επισκοπησ	noun-fem-η
επισπεύδω	επισπευδ	verb-a
επιστήμονας	επιστημον	noun-masc-ας
επιστημονικός	επιστημονικ	adj-ός
επιστολή	επιστολ	noun-fem-η
επιστράτευση	επιστρατευσ	noun-fem-η
επιστρέφω	επιστρεφ	verb-a
επιτάφιος	επιταφι	adj-ος
επιτάχυνση	επιταχυνσ	noun-fem-η
επιτέλους	επιτέλους	adv
επιτήρηση	επιτηρησ	noun-fem-η
επιτίθεμαι	επιτ	verb-
επιτακτικός	επιτακτικ	adj-ός
επιταχύνω	επιταχυν	verb-a
επιτρέπω	επιτρεπ	verb-a
επιτροπή	επιτροπ	noun-fem-η
επιτυγχάνω	επιτυγχαν	verb-a
επιτυχής	επιτυχ	adj-ής
επιτυχία	επιτυχι	noun-fem-α
επιτυχημένος	επιτυχημεν	adj-ος
επιφάνεια	επιφανει	noun-fem-α
επιφέρω	επιφερ	verb-a
επιφύλαξη	επιφυλαξ	noun-fem-η
επιχείρημα	επιχειρη	noun-neut-μα
επιχείρηση	επιχειρησ	noun-fem-η
επιχειρηματικός	επιχειρηματικ	adj-ός
επιχειρώ	επιχειρ	verb-b2
εποικοδομητικά	εποικοδομητικά	adv
εποικοδομητικός	εποικοδομητικ	adj-ός
εποικονωνίας	εποικονωνι	noun-masc-ας
επομένως	επομένως	adv
επονομαζόμενος	επονομαζομεν	adj-ος
εποπτεύω	εποπτευ	verb-a
εποχή	εποχη	noun-fem-η
εποχιακός	εποχιακ	adj-ός
επτά	επτά	num
επωμίζομαι	επωμι	verb-παθ
επωφελής	επωφελ	adj-ής
επωφελούμαι	επωφελου	verb-
επόμενος	επομεν	adj-ος
εργάζομαι	εργα	verb-παθ
εργάσιμος	εργασιμ	adj-ος
εργαζόμενος	εργαζομεν	noun-masc-ος
εργαλείο	εργαλει	noun-neut-ο
εργασία	εργασι	noun-fem-α
εργαστήρι	εργαστηρι	noun-neut-ι
εργατικός	εργατικ	adj-ός
εργοδότης	εργοδοτ	noun-masc-ης
εργολάβος	εργολαβ	noun-masc-ος
εργοστασιακός	εργοστασιακ	adj-ός
ερείπιο	ερειπ	noun-neut-ο
ερευνητικός	ερευνητικ	adj-ός
ερευνώ	ερευν	verb-b2
ερμηνεία	ερμηνει	noun-fem-α
ερμηνευτικός	ερμηνευτικ	adj-ός
ερμηνεύω	ερμηνευ	verb-a
ερυθρός	ερυθρ	adj-ός
ερχόμενος	ερχομεν	verb-
ερωτηθείς	ερωτηθείς	adj
ερωτικός	ερωτικ	adj-ός
ερώτημα	ερωτη	noun-neut-μα
ερώτηση	ερωτηση	noun-fem-η
εστία	εστι	noun-fem-α
εστιάζω	εστια	verb-a
εστιακός	εστιακ	adj-ός
εστιατόριο	εστιατορ	noun-neut-ο
εσωκομματικός	εσωκομματικ	adj-ός
εσωτερικά	εσωτερικά	noun
εσωτερικό	εσωτερικ	noun-neut-ο
εσωτερικός	εσωτερικ	adj-ός
ετήσιος	ετησι	adj-ος
εταίρος	εταιρ	noun-masc-ος
εταιρεία	εταιρει	noun-fem-α
εταιρικός	εταιρικ	adj-ός
ευάλωτος	ευαλωτ	adj-ος
ευέλικτος	ευελικτ	adj-ος
ευαγγέλιο	ευαγγελ	noun-neut-ο
ευαγγελίστρια	ευαγγελιστρι	noun-fem-α
ευαισθητοποίηση	ευαισθητοποιησ	noun-fem-η
ευγηρία	ευγηρι	noun-fem-α
ευγνώμων	ευγνώμων	adj
ευελιξία	ευελιξια	noun-fem-α
ευελπιστώ	ευελπιστ	verb-b2
ευεργετικός	ευεργετικ	adj-ός
ευημερία	ευημερι	noun-fem-α
ευθέως	ευθέως	adv
ευθεία	ευθει	noun-fem-α
ευθύνη	ευθυν	noun-fem-η
ευθύνομαι	ευθυν	verb-παθ
ευθύτητα	ευθυτητ	noun-fem-α
ευκαιρία	ευκαιρι	noun-fem-α
ευλογώ	ευλογ	verb-b2
ευνοώ	ευνο	verb-b2
ευπαθής	ευπαθ	adj-ής
ευρέως	ευρέως	adv
ευρεσιτεχνία	ευρεσιτεχνι	noun-fem-α
ευρωκοινοβούλιο	ευρωκοινοβουλ	noun-neut-ο
ευρωμεσογειακός	ευρωμεσογειακ	adj-ός
ευρωπαίος	ευρωπαι	adj-ος
ευρωπαϊκός	ευρωπαικ	adj-ός
ευρωσκεπτικιστής	ευρωσκεπτικιστ	noun-masc-ης
ευρύς	ευρ	adj-ύς
ευρώ	ευρώ	noun
ευτυχής	ευτυχ	adj-ής
ευχαρίστως	ευχαρίστως	adv
ευχαριστία	ευχαριστι	noun-fem-α
ευχαριστώ	ευχαριστ	verb-b2
ευχερής	ευχερ	adj-ής
εφέτης	εφετ	noun-masc-ης
εφαρμογή	εφαρμογη	noun-fem-η
εφαρμοστέος	εφαρμοστε	adj-ος
εφαρμόζω	εφαρμο	verb-a
εφεξής	εφεξής	adv
εφετείο	εφετε	noun-neut-ο
εφημερίδα	εφημεριδα	noun-fem-α
εφικτός	εφικτ	adj-ός
εφιστώ	εφιστ	verb-b2
εφοδιασμός	εφοδιασμ	noun-neut-ι
εφόδιο	εφοδ	noun-neut-ο
εφόσον	εφόσον	sconj
εχέγγυος	εχεγγυ	noun-masc-ος
εχθρός	εχθρ	noun-neut-ι
εύκολα	εύκολα	adv
εύκολος	ευκολ	adj-ος
εύλογος	ευλογ	adj-ος
εύρεση	ευρεσ	noun-fem-η
εύρημα	ευρη	noun-neut-μα
εύρος	ευρ	noun-masc-ος
εύστοχα	εύστοχα	adv
εύχομαι	ευχ	verb-παθ
ζήλος	ζηλο	noun-masc-ος
ζήτημα	ζητημα	noun-neut-μα
ζεματίστρα	ζεματιστρ	noun-fem-α
ζημιά	ζημιά	noun
ζητούμενος	ζητουμεν	noun-masc-ος
ζητωκραυγή	ζητωκραυγ	noun-fem-η
ζητώ	ζητ	verb-b2
ζοφερός	ζοφερ	adj-ός
ζυγός	ζυγ	noun-neut-ι
ζω	ζ	verb-a
ζωή	ζω	noun-fem-η
ζωικός	ζωικ	adj-ός
ζωντανεύω	ζωντανευ	verb-a
ζωντανός	ζωνταν	adj-ός
ζωτικός	ζωτικ	adj-ός
ζώνη	ζων	noun-fem-η
ζώο	ζω	noun-neut-ο
ηγέτης	ηγετ	noun-masc-ης
ηγεσία	ηγεσι	noun-fem-α
ηγετικός	ηγετικ	adj-ός
ηλεκτρικός	ηλεκτρικ	adj-ός
ηλεκτρονικά	ηλεκτρονικά	adv
ηλεκτρονικός	ηλεκτρονικ	adj-ός
ηλικία	ηλικια	noun-fem-α
ηλικιωμένος	ηλικιωμεν	noun-masc-ος
ηλιοβασίλεμα	ηλιοβασιλε	noun-neut-μα
ημέρα	ημερ	noun-fem-α
ημίχρονο	ημιχρον	noun-neut-ο
ημεδαπός	ημεδαπ	adj-ός
ημερήσιος	ημερησι	adj-ος
ημερομηνία	ημερομηνι	noun-fem-α
ημιαυτονομία	ημιαυτονομι	noun-fem-α
ημιερειπωμένος	ημιερειπωμεν	adj-ος
ημισέληνος	ημισελην	noun-masc-ος
ηνωμένος	ηνωμεν	adj-ος
ηρεμία	ηρεμι	noun-fem-α
ηττώμαι	ηττ	verb-παθ
θάλασσα	θαλασσ	noun-fem-α
θάνατος	θανατο	noun-masc-ος
θέα	θε	noun-fem-α
θέληση	θελησ	noun-fem-η
θέλω	θελ	verb-a
θέμα	θεμα	noun-neut-μα
θέρετρο	θερετρ	noun-neut-ο
θέση	θεσ	noun-fem-η
θέσπιση	θεσπισ	noun-fem-η
θέτω	θετ	verb-a
θίγω	θιγ	verb-a
θα	θα	aux
θαλάσσιος	θαλασσι	adj-ος
θαμνοκυπάρισσο	θαμνοκυπαρισσ	noun-neut-ο
θανάσιμος	θανασιμ	adj-ος
θανατηφόρος	θανατηφορ	adj-ος
θανατικός	θανατικ	adj-ός
θανατοποινίτης	θανατοποινιτ	noun-masc-ης
θανατώνω	θανατων	verb-a
θαυμάζω	θαυμαζ	verb-a
θείος	θει	adj-ος
θεαματικός	θεαματικ	adj-ός
θεμέλιο	θεμελ	noun-neut-ο
θεματικός	θεματικ	adj-ός
θεματοφύλακας	θεματοφυλακα	noun-masc-ας
θεμελιώδης	θεμελιωδ	adj-ης
θερίζω	θερι	verb-a
θεραπεύω	θεραπευ	verb-a
θερμά	θερμά	adv
θερμοκρασία	θερμοκρασι	noun-fem-α
θερμός	θερμ	adj-ός
θεσμικός	θεσμικ	adj-ός
θεσμοθετώ	θεσμοθετ	verb-b2
θεσπίζω	θεσπι	verb-a
θεσσαλικός	θεσσαλικ	adj-ός
θετικός	θετικ	adj-ός
θεωρώ	θεωρ	verb-b2
θεός	θε	noun-neut-ι
θεώρηση	θεωρηση	noun-fem-η
θητεία	θητει	noun-fem-α
θιβετιανός	θιβετιανός	propn
θνησιμότητα	θνησιμοτητ	noun-fem-α
θορυβώ	θορυβ	verb-b2
θρησκεία	θρησκεια	noun-fem-α
θρησκευτικός	θρησκευτικ	adj-ός
θριαμβευτικός	θριαμβευτικ	adj-ός
θρόμβος	θρομβ	noun-masc-ος
θρόνος	θρον	noun-masc-ος
θυελλώδης	θυελλωδ	adj-ης
θυμάμαι	θυμ	verb-παθ
θυμίζω	θυμι	verb-a
θυσία	θυσι	noun-fem-α
θυσιάζω	θυσιαζ	verb-a
θωρηκτό	θωρηκτ	noun-neut-ο
θόρυβος	θορυβ	noun-masc-ος
θύελλα	θυελλ	noun-fem-α
θύλακας	θυλακ	noun-masc-ας
θύμα	θυμα	noun-neut-μα
ιαπωνικός	ιαπωνικ	adj-ός
ιατρικός	ιατρικ	adj-ός
ιατροφαρμακευτικός	ιατροφαρμακευτικ	adj-ός
ιδέα	ιδεα	noun-fem-α
ιδίως	ιδίως	adv
ιδιαίτερα	ιδιαίτερα	adv
ιδιαίτερος	ιδιαιτερ	adj-ος
ιδιοκτήτης	ιδιοκτητ	noun-masc-ης
ιδιωτεύω	ιδιωτευ	verb-a
ιδιωτικοποιώ	ιδιωτικοποι	verb-b2
ιδιωτικός	ιδιωτικ	adj-ός
ιδιότητα	ιδιοτητ	noun-fem-α
ιδιώτης	ιδιωτ	noun-masc-ης
ιδρύω	ιδρυ	verb-a
ιεραρχώ	ιεραρχ	verb-b2
ιεροδιδασκαλείο	ιεροδιδασκαλε	noun-neut-ο
ιερό	ιερ	noun-neut-ο
ιερός	ιερ	adj-ός
ιθύνων	ιθύνων	adj
ικανοποίηση	ικανοποιησ	noun-fem-η
ικανοποιητικός	ικανοποιητικο	adj-ός
ικανοποιώ	ικανοποι	verb-b2
ικανός	ικαν	adj-ός
ικανότητα	ικανοτητα	noun-fem-α
ινδικός	ινδικ	adj-ός
ινστιτούτο	ινστιτουτο	noun-neut-ο
ιππασία	ιππασι	noun-fem-α
ιρανικός	ιρανικ	adj-ός
ισημερινός	ισημεριν	adj-ός
ισλαμικός	ισλαμικ	adj-ός
ισλαμιστής	ισλαμιστ	noun-masc-ης
ισοδυναμώ	ισοδυναμ	verb-b2
ισοπαλία	ισοπαλι	noun-fem-α
ισοπεδώνω	ισοπεδων	verb-a
ισορροπία	ισορροπι	noun-fem-α
ισορροπημένος	ισορροπημεν	adj-ος
ισοφαρίζω	ισοφαρι	verb-a
ισπανικός	ισπανικ	adj-ός
ισραηλινός	ισραηλιν	adj-ός
ιστορία	ιστορια	noun-fem-α
ιστορικός	ιστορικ	adj-ός
ισχυρίζομαι	ισχυρι	verb-παθ
ισχυροποίηση	ισχυροποιησ	noun-fem-η
ισχυρός	ισχυρ	adj-ός
ισχύς	ισχύς	noun
ισχύω	ισχυ	verb-a
ισχύων	ισχύων	adj
ισόβια	ισόβια	adj
ισόρροπος	ισορροπ	adj-ος
ισότιμος	ισοτιμ	adj-ος
κάθε	κάθε	det
κάθειρξη	καθειρξη	noun-fem-η
κάθετος	καθετο	adj-ος
κάθομαι	καθ	verb-παθ
κάμερα	καμερ	noun-fem-α
κάνω	καν	verb-a
κάποιος	κάποιος	det
κάποτε	κάποτε	adv
κάπου	κάπου	adv
κάπως	κάπως	adv
κάρτα	καρτ	noun-fem-α
κάστρο	κάστρο	propn
κάτι	κατι	pron-neut-ι
κάτοικος	κατοικ	noun-masc-ος
κάτοχος	κατοχ	noun-masc-ος
κάτω	κάτω	adv
κέντρο	κεντρ	noun-neut-ο
κήπος	κηπ	noun-masc-ος
κίνδυνος	κινδυνο	noun-masc-ος
κίνημα	κινημα	noun-neut-μα
κίνηση	κινησ	noun-fem-η
κίνητρο	κινητρ	noun-neut-ο
καΐκι	καικι	noun-neut-ι
καίριος	καιρι	adj-ος
καίω	και	verb-a
καθένας	καθε	pron-masc-ας
καθήκον	καθήκον	noun
καθίσταμαι	καθιστ	verb-
καθαριότητα	καθαριοτητ	noun-fem-α
καθεαυτός	καθεαυτ	adj-ός
καθεστωτικός	καθεστωτικ	adj-ός
καθεστώς	καθεστώς	noun
καθηλωμένος	καθηλωμεν	adj-ος
καθημερινά	καθημερινά	adv
καθημερινός	καθημεριν	adj-ός
καθιέρωση	καθιερωσ	noun-fem-η
καθιερώνω	καθιερω	verb-a
καθιστώ	καθιστ	verb-b2
καθοδηγώ	καθοδηγ	verb-b2
καθολικός	καθολικ	adj-ός
καθορίζω	καθορι	verb-a
καθορισμός	καθορισμ	noun-neut-ι
καθοριστικός	καθοριστικ	adj-ός
καθυστέρηση	καθυστερησ	noun-fem-η
καθυστερώ	καθυστερ	verb-b2
καθόλου	καθόλου	adv
καθότι	καθότι	sconj
καθώς	καθώς	adv
και	και	cconj
καινοτομία	καινοτομι	noun-fem-α
καινοτόμος	καινοτομ	adj-ος
καινούργιος	καινουργι	adj-ος
καιρικός	καιρικ	adj-ός
καιρός	καιρο	noun-neut-ι
κακοκαιρία	κακοκαιρι	noun-fem-α
κακός	κακ	adj-ός
καλά	καλά	adv
καλλιέργεια	καλλιεργει	noun-fem-α
καλλιεργώ	καλλιεργ	verb-b2
καλοδεχούμενος	καλοδεχουμεν	adj-ος
καλοκαίρι	καλοκαιρι	noun-neut-ι
καλωσορίζω	καλωσορι	verb-a
καλός	καλ	adj-ός
καλύπτω	καλυ	verb-a
καλώ	καλ	verb-b2
καμάρα	καμαρ	noun-fem-α
καμπάνια	καμπανι	noun-fem-α
καν	καν	adv
κανένας	κανένας	det
κανονικά	κανονικά	adv
κανονισμός	κανονισμ	noun-neut-ι
κανονιστικός	κανονιστικ	adj-ός
καντούνι	καντουνι	noun-neut-ι
καντόνι	καντονι	noun-neut-ι
κανόνας	κανον	noun-masc-ας
κανόνι	κανονι	noun-neut-ι
καρδιαγγειακός	καρδιαγγειακ	adj-ός
καρκίνος	καρκινο	noun-masc-ος
καρκινογόνος	καρκινογον	adj-ος
καρπός	καρπ	noun-neut-ι
κατά	κατά	adp
κατάγομαι	καταγ	verb-παθ
κατάδυση	καταδυσ	noun-fem-η
κατάθεση	καταθεσ	noun-fem-η
κατάλληλος	καταλληλο	adj-ος
κατάλογος	καταλογο	noun-masc-ος
κατάπαυση	καταπαυση	noun-fem-η
κατάργηση	καταργησ	noun-fem-η
κατάρρευση	καταρρευσ	noun-fem-η
κατάρτιση	καταρτιση	noun-fem-η
κατάσταση	καταστασ	noun-fem-η
κατάσχω	κατασχ	verb-a
κατάταξη	καταταξ	noun-fem-η
κατάφωρος	καταφωρ	adj-ος
κατάχρηση	καταχρησ	noun-fem-η
κατέχω	κατε	verb-a
καταβάλλω	καταβ	verb-a
καταβολή	καταβολ	noun-fem-η
καταγάλανος	καταγαλαν	adj-ος
καταγγέλλω	καταγγελλ	verb-a
καταγγελία	καταγγελι	noun-fem-α
καταγεγγραμένο	καταγεγγραμεν	verb-
καταγράφω	καταγραφ	verb-a
καταγωγή	καταγωγ	noun-fem-η
καταδεικνύω	καταδεικνυ	verb-a
καταδικάζω	καταδικα	verb-a
καταδιώκω	καταδιωκ	verb-a
καταζητώ	καταζητ	verb-b2
καταθέτης	καταθετ	noun-masc-ης
καταθέτω	καταθετ	verb-a
κατακλείδι	κατακλειδι	noun-neut-ι
κατακρίνω	κατακριν	verb-a
καταλήγω	καταληγ	verb-a
καταλαβαίνω	καταλαβαιν	verb-a
καταλαμβάνω	καταλαμβαν	verb-a
καταληκτικός	καταληκτικ	adj-ός
καταμετρημένος	καταμετρημεν	adj-ος
καταναλωτής	καταναλωτ	noun-masc-ης
κατανομή	κατανομ	noun-fem-η
κατανοώ	κατανο	verb-b2
κατανόηση	κατανοησ	noun-fem-η
καταπίεση	καταπιεσ	noun-fem-η
καταπολέμηση	καταπολεμηση	noun-fem-η
καταπολεμώ	καταπολεμ	verb-b2
καταπράσινος	καταπρασιν	adj-ος
καταργώ	καταργ	verb-b2
καταρρέω	καταρρ	verb-b1
καταρτίζω	καταρτιζ	verb-a
καταρχάς	καταρχάς	adv
καταρχήν	καταρχήν	adv
κατασκευή	κατασκευη	noun-fem-η
κατασκευαστής	κατασκευαστ	noun-masc-ης
κατασκευαστικός	κατασκευαστικ	adj-ός
καταστατικό	καταστατικ	noun-neut-ο
καταστολή	καταστολη	noun-fem-η
καταστρέφω	καταστρεφ	verb-a
καταστρεπτικός	καταστρεπτικ	adj-ός
καταστροφή	καταστροφ	noun-fem-η
καταστροφικός	καταστροφικ	adj-ός
κατατάσσω	κατατα	verb-a
καταφέρνω	καταφερ	verb-a
καταφεύγω	καταφευγ	verb-a
καταφύγιο	καταφυγ	noun-neut-ο
καταχωρώ	καταχωρ	verb-b2
καταψήφιση	καταψηφισ	noun-fem-η
καταψηφίζω	καταψηφι	verb-a
κατευθυντήριος	κατευθυντηρι	adj-ος
κατευθύνω	κατευθυν	verb-a
κατεύθυνση	κατευθυνσ	noun-fem-η
κατηγορία	κατηγορι	noun-fem-α
κατηγορούμενος	κατηγορουμεν	adj-ος
κατηγορώ	κατηγορ	verb-b2
κατοικία	κατοικι	noun-fem-α
κατονομάζω	κατονομαζ	verb-a
κατορθώνω	κατορθω	verb-a
κατοχή	κατοχη	noun-fem-η
κατσαδιάζω	κατσαδιαζ	verb-a
κατόπιν	κατόπιν	adv
κατώφλι	κατωφλι	noun-neut-ι
κατώφλιο	κατωφλι	noun-neut-ο
καυσαέριο	καυσαερ	noun-neut-ο
καφετέρια	καφετερι	noun-fem-α
κείμενο	κειμεν	noun-neut-ο
κείμενος	κειμεν	noun-masc-ος
κειμήλιο	κειμηλ	noun-neut-ο
κελί	κελί	noun
κεντρικός	κεντρικ	adj-ός
κεντρώος	κεντρω	adj-ος
κενό	κεν	noun-neut-ο
κερί	κερί	noun
κερδίζω	κερδι	verb-a
κεφάλαιο	κεφαλαιο	noun-neut-ο
κεφαλή	κεφαλ	noun-fem-η
κηλιδώνω	κηλιδων	verb-a
κηρύσσω	κηρυ	verb-a
κινέζικος	κινεζικ	adj-ος
κινδυνεύω	κινδυνευ	verb-a
κινεζικός	κινεζικ	adj-ός
κινηματογράφος	κινηματογραφ	noun-masc-ος
κινητήρας	κινητηρ	noun-masc-ας
κινητικότητα	κινητικοτητ	noun-fem-α
κινητοποίηση	κινητοποιησ	noun-fem-η
κινητός	κινητ	adj-ός
κινώ	κιν	verb-b2
κλάδος	κλαδ	noun-masc-ος
κλίβανος	κλιβαν	noun-masc-ος
κλίμα	κλι	noun-neut-μα
κλίμακα	κλιμακα	noun-fem-α
κλασσικός	κλασσικ	adj-ός
κλείνω	κλειν	verb-a
κλείσιμο	κλεισιμ	noun-neut-ο
κλειδί	κλειδί	noun
κλειστός	κλειστ	adj-ός
κληρικός	κληρικ	noun-neut-ι
κληροδοτώ	κληροδοτ	verb-b2
κληρονομιά	κληρονομιά	noun
κλιματικός	κλιματικ	adj-ός
κοίτασμα	κοιτασ	noun-neut-μα
κογκρέσο	κογκρεσ	noun-neut-ο
κοιλάδα	κοιλαδ	noun-fem-α
κοινοβουλευτικός	κοινοβουλευτικ	adj-ός
κοινοβούλιο	κοινοβουλι	noun-neut-ο
κοινοποίηση	κοινοποιηση	noun-fem-η
κοινοπραξία	κοινοπραξι	noun-fem-α
κοινοτικός	κοινοτικ	adj-ός
κοινωνία	κοινωνια	noun-fem-α
κοινωνικά	κοινωνικά	adv
κοινωνικός	κοινωνικ	adj-ός
κοινό	κοινο	noun-neut-ο
κοινός	κοιν	adj-ός
κοινότητα	κοινοτητ	noun-fem-α
κοιτάζω	κοιταζ	verb-a
κολοκοτρώνης	κολοκοτρώνης	propn
κολύμπι	κολυμπι	noun-neut-ι
κομμάτι	κομματι	noun-neut-ι
κομματικός	κομματικ	adj-ός
κομμουνισμός	κομμουνισμ	noun-neut-ι
κομμουνιστής	κομμουνιστ	noun-masc-ης
κομμουνιστικός	κομμουνιστικ	adj-ός
κομπίνα	κομπιν	noun-fem-α
κονδύλιο	κονδυλ	noun-neut-ο
κοντά	κοντά	adv
κοντινός	κοντιν	adj-ός
κοπτικός	κοπτικ	adj-ός
κορίτσι	κοριτσι	noun-neut-ι
κορυφή	κορυφ	noun-fem-η
κορυφώνω	κορυφων	verb-a
κοσμικός	κοσμικ	adj-ός
κοστίζω	κοστιζ	verb-a
κουβανικός	κουβανικ	adj-ός
κουκουναριά	κουκουναριά	noun
κουλτούρα	κουλτουρ	noun-fem-α
κουρσάρος	κουρσαρ	noun-masc-ος
κούνια	κουνι	noun-fem-α
κούραση	κουρασ	noun-fem-η
κούρος	κουρ	noun-masc-ος
κράτηση	κρατησ	noun-fem-η
κράτος	κρατ	noun-masc-ος
κρίνω	κριν	verb-a
κρίση	κριση	noun-fem-η
κρίσιμος	κρισιμ	adj-ος
κρανίο	κραν	noun-neut-ο
κρασάς	κρασάς	propn
κρατίδιο	κρατιδ	noun-neut-ο
κρατικός	κρατικ	adj-ός
κρατούμενος	κρατουμεν	noun-masc-ος
κρατώ	κρατ	verb-b2
κραυγή	κραυγ	noun-fem-η
κρεμώ	κρεμ	verb-b2
κρητικός	κρητικ	adj-ός
κριμαϊκός	κριμαικ	adj-ός
κριτήριο	κριτηρι	noun-neut-ο
κριτική	κριτικη	noun-fem-η
κρούσμα	κρουσ	noun-neut-μα
κρύβω	κρυβ	verb-a
κτίζω	κτιζ	verb-a
κτίριο	κτιρι	noun-neut-ο
κτίσμα	κτισμα	noun-neut-μα
κτιριακός	κτιριακ	adj-ός
κτώμαι	κτ	noun-neut-ι
κυβέρνηση	κυβερνησ	noun-fem-η
κυβερνήτης	κυβερνητ	noun-masc-ης
κυβερνητικός	κυβερνητικ	adj-ός
κυκλαδίτικος	κυκλαδιτικ	adj-ος
κυκλοφορία	κυκλοφορι	noun-fem-α
κυκλοφορώ	κυκλοφορ	verb-b2
κυκλοφορών	κυκλοφορών	adj
κυκλώνω	κυκλων	verb-a
κυλώ	κυλ	verb-b2
κυνήγι	κυνηγι	noun-neut-ι
κυπριακός	κυπριακ	adj-ός
κυρά	κυρά	noun
κυρία	κυρι	noun-fem-α
κυρίως	κυρίως	adv
κυριαρχία	κυριαρχια	noun-fem-α
κυριαρχώ	κυριαρχ	verb-b2
κυριολεξία	κυριολεξι	noun-fem-α
κυρώνω	κυρων	verb-a
κυτίο	κυτ	noun-neut-ο
κωδικός	κωδικ	adj-ός
κόβω	κοβ	verb-a
κόγχη	κογχ	noun-fem-η
κόκκινος	κοκκιν	adj-ος
κόλπος	κολπ	noun-masc-ος
κόμμα	κομμα	noun-neut-μα
κόπος	κοπ	noun-masc-ος
κόπτης	κοπτ	noun-masc-ης
κόσμος	κοσμο	noun-masc-ος
κόστος	κοστο	noun-masc-ος
κύκλος	κυκλο	noun-masc-ος
κύκνος	κυκν	noun-masc-ος
κύμα	κυμα	noun-neut-μα
κύριος	κυρι	noun-masc-ος
κύρωση	κυρωσ	noun-fem-η
κύτταρο	κυτταρ	noun-neut-ο
κώδικας	κωδικα	noun-masc-ας
λάδι	λαδι	noun-neut-ι
λάθος	λαθ	noun-masc-ος
λάτρης	λατρ	noun-masc-ης
λέγω	λεγ	verb-a
λέξη	λεξ	noun-fem-η
λήγω	ληγ	verb-a
λήξη	ληξ	noun-fem-η
λήψη	ληψη	noun-fem-η
λίγο	λίγο	adv
λίγος	λιγ	adj-ος
λίθος	λιθ	noun-masc-ος
λίμνη	λιμν	noun-fem-η
λίστα	λιστ	noun-fem-α
λαθρεμπόριο	λαθρεμπορ	noun-neut-ο
λαμβάνω	λαμβαν	verb-a
λατινικός	λατινικ	adj-ός
λατομείο	λατομε	noun-neut-ο
λατρεία	λατρει	noun-fem-α
λατρευτικός	λατρευτικ	adj-ός
λαφυραγωγώ	λαφυραγωγ	verb-b2
λαϊκισμός	λαικισμ	noun-neut-ι
λαϊκός	λαικο	adj-ός
λαός	λα	noun-neut-ι
λείπω	λειπ	verb-a
λεγόμενος	λεγομεν	adj-ος
λειτουργία	λειτουργι	noun-fem-α
λειτουργώ	λειτουργ	verb-b2
λειτούργημα	λειτουργη	noun-neut-μα
λεκανοπέδιο	λεκανοπεδ	noun-neut-ο
λεπτομέρεια	λεπτομερει	noun-fem-α
λεπτομερής	λεπτομερ	adj-ής
λεπτομερώς	λεπτομερώς	adv
λεπτό	λεπτ	noun-neut-ο
λευκός	λευκ	adj-ός
λεωφορείο	λεωφορει	noun-neut-ο
λησμονώ	λησμον	verb-b2
λιγοστεύω	λιγοστευ	verb-a
λιγοστός	λιγοστ	adj-ός
λιθοσκέπαστος	λιθοσκεπαστ	adj-ος
λιμάνι	λιμανι	noun-neut-ι
λιμενικός	λιμενικ	adj-ός
λιμνούλα	λιμνουλ	noun-fem-α
λιοντάρι	λιονταρι	noun-neut-ι
λιτότητα	λιτοτητ	noun-fem-α
λογαριασμός	λογαριασμ	noun-neut-ι
λογικός	λογικ	adj-ός
λογιστική	λογιστικ	noun-fem-η
λογιστικός	λογιστικ	adj-ός
λοιπόν	λοιπόν	adv
λοιπός	λοιπ	adj-ός
λουλούδι	λουλουδι	noun-neut-ι
λυγίζω	λυγιζ	verb-a
λυπηρός	λυπηρ	adj-ός
λυπούμαι	λυπ	verb-
λόγος	λογ	noun-masc-ος
λόγω	λόγω	noun
λόμπι	λομπι	noun-neut-ι
λόφος	λοφ	noun-masc-ος
λύκος	λυκ	noun-masc-ος
λύνω	λυν	verb-a
λύση	λυσ	noun-fem-η
λύτρωση	λυτρωσ	noun-fem-η
μάθηση	μαθησ	noun-fem-η
μάλιστα	μάλιστα	adv
μάλλον	μάλλον	adv
μάρκα	μαρκ	noun-fem-α
μάρκο	μαρκ	noun-neut-ο
μάρμαρο	μαρμαρ	noun-neut-ο
μάρτυρας	μαρτυρ	noun-masc-ας
μάτι	ματι	noun-neut-ι
μάχη	μαχ	noun-fem-η
μέγεθος	μεγεθ	noun-masc-ος
μέθοδος	μεθοδο	noun-masc-ος
μέλημα	μελημα	noun-neut-μα
μέλλον	μέλλον	noun
μέλος	μελ	noun-masc-ος
μένω	μεν	verb-a
μέρα	μερ	noun-fem-α
μέρει	μερει	noun-neut-ι
μέρος	μερ	noun-masc-ος
μέσα	μέσα	adv
μέσο	μεσ	noun-neut-ο
μέσος	μεσ	noun-masc-ος
μέσω	μέσω	adp
μέτρο	μετρ	noun-neut-ο
μέτωπο	μετωπο	noun-neut-ο
μέχρι	μέχρι	adp
μήκος	μηκ	noun-masc-ος
μήνας	μην	noun-masc-ας
μήνυμα	μηνυμα	noun-neut-μα
μήπως	μήπως	adv
μίσος	μισ	noun-masc-ος
μαγευτικός	μαγευτικ	adj-ός
μαγεύω	μαγευ	verb-a
μαζί	μαζί	adv
μαζεύω	μαζευ	verb-a
μαθαίνω	μαθαιν	verb-a
μαθησιακός	μαθησιακ	adj-ός
μαθητής	μαθητ	noun-masc-ης
μακάβριος	μακαβρι	adj-ος
μακεδονικός	μακεδονικ	adj-ός
μακεδόνας	μακεδόνας	propn
μακελειό	μακελε	noun-neut-ο
μακριά	μακριά	adv
μακροπρόθεσμος	μακροπροθεσμ	adj-ος
μακροχρόνιος	μακροχρονι	adj-ος
μακρύς	μακρ	adj-ύς
μαραθώνιος	μαραθωνι	adj-ος
μαρτυρώ	μαρτυρ	verb-b2
ματιά	ματιά	noun
μαυροπετρίτης	μαυροπετριτ	adj-ης
μαχητός	μαχητ	adj-ός
μαύρος	μαύρος	propn
με	με	adp
μείωση	μειωσ	noun-fem-η
μεγάλος	μεγαλ	adj-ος
μεγιστοποίηση	μεγιστοποιησ	noun-fem-η
μεγιστοποιώ	μεγιστοποι	verb-b2
μεθαύριο	μεθαύριο	adv
μεθεπόμενος	μεθεπομεν	adj-ος
μεθοδολογία	μεθοδολογι	noun-fem-α
μειονέκτημα	μειονεκτη	noun-neut-μα
μειονεκτικός	μειονεκτικ	adj-ός
μειονότητα	μειονοτητ	noun-fem-α
μειοψηφία	μειοψηφια	noun-fem-α
μειώνω	μειω	verb-a
μελέτη	μελετη	noun-fem-η
μελετώ	μελετ	verb-b2
μελιός	μελι	noun-neut-ι
μελλοντικά	μελλοντικά	adv
μελλοντικός	μελλοντικ	adj-ός
μεμονωμένος	μεμονωμεν	adj-ος
μεν	μεν	adv
μερικοί	μερικοί	det
μερικός	μερικ	adj-ός
μερικώς	μερικώς	adv
μεριμνώ	μεριμν	verb-b2
μεσάζοντας	μεσαζοντ	noun-masc-ας
μεσαίος	μεσαι	adj-ος
μεσαίωνας	μεσαίωνας	propn
μεσαιωνικός	μεσαιωνικ	adj-ός
μεσημέρι	μεσημερι	noun-neut-ι
μεσογειακός	μεσογειακ	adj-ός
μεσολάβηση	μεσολαβησ	noun-fem-η
μεσολαβητικός	μεσολαβητικ	adj-ός
μετά	μετά	adv
μετάβαση	μεταβαση	noun-fem-η
μετέχω	μετεχ	verb-a
μεταβάλλω	μεταβ	verb-a
μεταβίβαση	μεταβιβασ	noun-fem-η
μεταβαίνω	μεταβαιν	verb-a
μεταβατικός	μεταβατικ	adj-ός
μεταβιβάζω	μεταβιβα	verb-a
μεταδίδω	μεταδιδ	verb-a
μετακίνηση	μετακινηση	noun-fem-η
μετακινώ	μετακιν	verb-b2
μετανάστευση	μεταναστευσ	noun-fem-η
μετανάστης	μεταναστ	noun-masc-ης
μεταναστευτικός	μεταναστευτικ	adj-ός
μεταξύ	μεταξύ	adv
μεταρρυθμιστικός	μεταρρυθμιστικ	adj-ός
μεταρρύθμιση	μεταρρυθμισ	noun-fem-η
μεταστροφή	μεταστροφ	noun-fem-η
μετατρέπω	μετατρεπ	verb-a
μεταφέρω	μεταφερ	verb-a
μεταφορά	μεταφορά	noun
μεταφορέας	μεταφορε	noun-masc-ας
μεταχείριση	μεταχειριση	noun-fem-η
μετεγκατάσταση	μετεγκαταστασ	noun-fem-η
μετεκπαίδευση	μετεκπαιδευσ	noun-fem-η
μετεπιβίβαση	μετεπιβιβασ	noun-fem-η
μετεωρολογικός	μετεωρολογικ	adj-ός
μετρήσιμος	μετρησιμ	adj-ος
μετριάζω	μετριάζω	adj
μετριοπαθής	μετριοπαθ	adj-ής
μετρώ	μετρ	verb-b2
μην	μην	part
μητέρα	μητερ	noun-fem-α
μηχάνημα	μηχανη	noun-neut-μα
μηχανή	μηχαν	noun-fem-η
μηχανισμός	μηχανισμ	noun-neut-ι
μιας	μιας	sconj
μικρασιατικός	μικρασιατικ	adj-ός
μικρός	μικρ	adj-ός
μιλώ	μιλ	verb-b2
μιναρές	μιναρές	noun
μισθός	μισθ	noun-neut-ι
μισοχαλασμένο	μισοχαλασμένο	adj
μισό	μισ	noun-neut-ο
μισός	μισο	adj-ός
μνημείο	μνημει	noun-neut-ο
μοίρα	μοιρ	noun-fem-α
μοιάζω	μοιαζ	verb-a
μοιράζω	μοιραζ	verb-a
μονάδα	μοναδ	noun-fem-α
μονάρχης	μοναρχ	noun-masc-ης
μονάχα	μονάχα	adv
μονάχος	μοναχ	adj-ος
μονή	μονη	noun-fem-η
μοναδικός	μοναδικ	adj-ός
μοναδικότητα	μοναδικοτητ	noun-fem-α
μοναστήρι	μοναστηρι	noun-neut-ι
μοναστηριακός	μοναστηριακ	adj-ός
μοναχός	μοναχ	noun-neut-ι
μονομερώς	μονομερώς	adv
μονοπάτι	μονοπατι	noun-neut-ι
μονοπώλιο	μονοπωλ	noun-neut-ο
μορφή	μορφη	noun-fem-η
μορφολογία	μορφολογι	noun-fem-α
μου	μου	pron
μουσείο	μουσε	noun-neut-ο
μουσουλμάνος	μουσουλμαν	noun-masc-ος
μουσουλμανικός	μουσουλμανικ	adj-ός
μπάλα	μπαλ	noun-fem-α
μπαίνω	μπαιν	verb-a
μπανάνα	μπαναν	noun-fem-α
μπαρ	μπαρ	noun
μπλέκω	μπλεκ	verb-a
μπλε	μπλε	adj
μπορώ	μπορ	verb-b2
μπροστά	μπροστά	adv
μυθολογία	μυθολογι	noun-fem-α
μυλωνάς	μυλωνάς	noun
μυρίζω	μυριζ	verb-a
μυστήριο	μυστηρ	noun-neut-ο
μυστήριος	μυστηρι	adj-ος
μυστικός	μυστικ	adj-ός
μόλις	μόλις	adv
μόνιμος	μονιμ	adj-ος
μόνο	μόνο	adv
μόνος	μον	adj-ος
μόρφωση	μορφωσ	noun-fem-η
μώλος	μώλος	propn
νέος	νε	adj-ος
νέων	νέων	noun
νήσος	νησ	noun-masc-ος
νίκη	νικ	noun-fem-η
να	να	aux
ναζιστικός	ναζιστικ	adj-ός
ναι	ναι	adv
ναρκωτικός	ναρκωτικ	noun-neut-ι
νατοϊκός	νατοικ	adj-ός
ναυλοχώ	ναυλοχ	verb-b2
ναυμαχία	ναυμαχι	noun-fem-α
ναυτικός	ναυτικ	adj-ός
ναός	να	noun-neut-ι
ναύαρχος	ναυαρχ	noun-masc-ος
νεαρός	νεαρ	adj-ός
νεκρομαντείο	νεκρομαντε	noun-neut-ο
νεκροταφείο	νεκροταφε	noun-neut-ο
νεκρόπολη	νεκροπολ	noun-fem-η
νεκρός	νεκρ	noun-neut-ι
νεογνό	νεογν	noun-neut-ο
νεολαία	νεολαια	noun-fem-α
νεοναζί	νεοναζί	noun
νεοναζιστικός	νεοναζιστικ	adj-ός
νεοσχηματισθείσα	νεοσχηματισθείσα	adj
νερό	νερ	noun-neut-ο
νερόλακκος	νερολακκ	noun-masc-ος
νευρολογικός	νευρολογικ	adj-ός
νευρώνας	νευρων	noun-masc-ας
νεόπτωχος	νεοπτωχ	adj-ος
νεότουρκος	νεότουρκος	propn
νησάκι	νησακι	noun-neut-ι
νησί	νησί	noun
νικητής	νικητ	noun-masc-ης
νικώ	νικ	verb-b2
νιώθω	νιωθ	verb-a
νομίζω	νομιζ	verb-a
νομικά	νομικά	adv
νομικός	νομικ	adj-ός
νομιμότητα	νομιμοτητ	noun-fem-α
νομισματικός	νομισματικ	adj-ός
νομοθέτης	νομοθετ	noun-masc-ης
νομοθεσία	νομοθεσια	noun-fem-α
νομοθετικός	νομοθετικ	adj-ός
νομολογία	νομολογι	noun-fem-α
νομοσχέδιο	νομοσχεδ	noun-neut-ο
νομός	νομ	noun-neut-ι
νοσοκομείο	νοσοκομει	noun-neut-ο
νοτιοανατολικός	νοτιοανατολικ	adj-ός
νοτιοδυτικά	νοτιοδυτικά	adv
νους	νους	noun
ντρέπομαι	ντρεπ	verb-παθ
ντόπιος	ντοπι	adj-ος
νωρίς	νωρίς	adv
νόημα	νοη	noun-neut-μα
νόμιμα	νόμιμα	adv
νόμιμος	νομιμ	adj-ος
νόμισμα	νομισμα	noun-neut-μα
νόμος	νομ	noun-masc-ος
νόσος	νοσ	noun-masc-ος
νότια	νότια	adv
νότιοδυτικό	νότιοδυτικό	adj
νότιος	νοτι	adj-ος
νότος	νοτ	noun-masc-ος
νύμφη	νυμφ	noun-fem-η
νύχτα	νυχτα	noun-fem-α
ξένος	ξεν	adj-ος
ξέρω	ξερ	verb-a
ξέσπασμα	ξεσπασ	noun-neut-μα
ξανά	ξανά	adv
ξαναβάζω	ξαναβαζ	verb-a
ξαναγράφω	ξαναγραφ	verb-a
ξαναζητώ	ξαναζητ	verb-b2
ξανακτίζω	ξανακτιζ	verb-a
ξανασυναντώ	ξανασυναντ	verb-b2
ξανασυνεδριάζω	ξανασυνεδριαζ	verb-a
ξεκάθαρα	ξεκάθαρα	adv
ξεκάθαρος	ξεκαθαρ	adj-ος
ξεκίνημα	ξεκινη	noun-neut-μα
ξεκινώ	ξεκιν	verb-b2
ξενάγηση	ξεναγησ	noun-fem-η
ξεναγώ	ξεναγ	verb-b2
ξενοδοχείο	ξενοδοχε	noun-neut-ο
ξενώνας	ξενων	noun-masc-ας
ξεπερνώ	ξεπερ	verb-b2
ξεσηκώνω	ξεσηκων	verb-a
ξεσπώ	ξεσπ	verb-b2
ξεχνώ	ξεχν	verb-b2
ξεχωρίζω	ξεχωριζ	verb-a
ξημέρωμα	ξημερω	noun-neut-μα
ξηρά	ξηρά	noun
ξυλένιος	ξυλενι	adj-ος
ξυλοκοπώ	ξυλοκοπ	verb-b2
ξύλο	ξυλο	noun-neut-ο
ο	ο	det
οίκος	οικο	noun-masc-ος
οβίδα	οβιδ	noun-fem-α
οδήγηση	οδηγηση	noun-fem-η
οδεύω	οδευ	verb-a
οδηγία	οδηγι	noun-fem-α
οδηγός	οδηγ	noun-neut-ι
οδηγώ	οδηγ	verb-b2
οδικός	οδικ	adj-ός
οδικώς	οδικώς	adv
οδυνηρός	οδυνηρ	adj-ός
οδός	οδ	noun-neut-ι
οθωμανικός	οθωμανικ	adj-ός
οικισμός	οικισμο	noun-neut-ι
οικογένεια	οικογενει	noun-fem-α
οικοδεσπότης	οικοδεσποτ	noun-masc-ης
οικοδομή	οικοδομ	noun-fem-η
οικοδόμηση	οικοδομησ	noun-fem-η
οικολογικός	οικολογικ	adj-ός
οικονομία	οικονομι	noun-fem-α
οικονομικά	οικονομικά	noun
οικονομικός	οικονομικ	adj-ός
οιοσδήποτε	οιοσδήποτε	det
οκτώ	οκτώ	num
ολίγος	ολιγ	adj-ος
ολοένα	ολοένα	adv
ολοκλήρωση	ολοκληρωσ	noun-fem-η
ολοκληρώνω	ολοκληρω	verb-a
ολομέλεια	ολομελει	noun-fem-α
ολονύκτιος	ολονυκτι	adj-ος
ολυμπιακός	ολυμπιακ	adj-ός
ολόκληρος	ολοκληρ	adj-ος
ολότητα	ολοτητ	noun-fem-α
ομάδα	ομαδ	noun-fem-α
ομαδικά	ομαδικά	adv
ομαλός	ομαλ	adj-ός
ομιλία	ομιλι	noun-fem-α
ομιλητής	ομιλητ	noun-masc-ης
ομοιότητα	ομοιοτητ	noun-fem-α
ομολογώ	ομολογ	verb-b2
ομορφιά	ομορφιά	noun
ομοσπονδία	ομοσπονδι	noun-fem-α
ομοσπονδιακός	ομοσπονδιακ	adj-ός
ομφαλοσκόπηση	ομφαλοσκοπηση	noun-fem-η
ομόλογο	ομολογ	noun-neut-ο
ομόλογος	ομολογ	noun-masc-ος
ομόσπονδος	ομοσπονδ	adj-ος
ομόφωνα	ομόφωνα	adv
ομόφωνος	ομοφων	adj-ος
ονομάζω	ονομα	verb-a
ονομασία	ονομασι	noun-fem-α
οπαδός	οπαδ	noun-neut-ι
οπισθοδρόμηση	οπισθοδρομησ	noun-fem-η
οπλαρχηγός	οπλαρχηγ	noun-neut-ι
οπλισμός	οπλισμ	noun-neut-ι
οπλοστάσιο	οπλοστασ	noun-neut-ο
οποίος	οποι	pron-masc-ος
οποιοσδήποτε	οποιοσδήποτε	det
οπουδήποτε	οπουδήποτε	adv
οπωσδήποτε	οπωσδήποτε	adv
οπότε	οπότε	cconj
ορίζω	οριζ	verb-a
ορατός	ορατ	adj-ός
οργάνωση	οργανωσ	noun-fem-η
οργανισμός	οργανισμ	noun-neut-ι
οργανώνω	οργανων	verb-a
ορεινός	ορειν	adj-ός
ορθά	ορθά	adv
ορθό	ορθό	adj
ορθόδοξος	ορθοδοξ	adj-ος
ορθός	ορθ	adj-ός
οριζόντιος	οριζοντι	adj-ος
οριοθέτηση	οριοθετησ	noun-fem-η
ορισμένος	ορισμεν	adj-ος
ορισμός	ορισμο	noun-neut-ι
οριστικά	οριστικά	adv
οριστικός	οριστικ	adj-ός
ορκίζω	ορκιζ	verb-a
ορόσημο	οροσημ	noun-neut-ο
ος	ος	det
οσμή	οσμ	noun-fem-η
οτιδήποτε	οτιδήποτε	det
ουδείς	ουδείς	adj
ουζερί	ουζερί	noun
ουρανός	ουραν	noun-neut-ι
ουσία	ουσι	noun-fem-α
ουσιαστικά	ουσιαστικά	adv
ουσιαστικός	ουσιαστικ	adj-ός
ουσιώδης	ουσιωδ	adj-ης
οφείλω	οφειλ	verb-a
οχυρώνω	οχυρω	verb-a
ούτε	ούτε	cconj
ούτως	ούτως	adv
πάθηση	παθησ	noun-fem-η
πάλι	πάλι	adv
πάν	πάν	noun
πάντα	πάντα	adv
πάντοτε	πάντοτε	adv
πάντως	πάντως	adv
πάνω	πάνω	adv
πάπας	παπ	noun-masc-ας
πάπια	παπι	noun-fem-α
πάρα	πάρα	adv
πάραυτα	πάραυτα	adv
πάρεργος	παρεργ	noun-masc-ος
πάρκο	παρκ	noun-neut-ο
πάσχων	πάσχων	adj
πάτωμα	πατω	noun-neut-μα
πέλαγος	πελαγ	noun-masc-ος
πέμπτος	πέμπτος	adv
πένθος	πενθ	noun-masc-ος
πέντε	πέντε	num
πέντε-δέκα	πέντε-δέκα	num
πέρα	πέρα	adv
πέραν	πέραν	adv
πέρας	περ	noun-masc-ας
πέρδικα	πέρδικα	propn
πέρυσι	πέρυσι	adv
πέτρα	πετρ	noun-fem-α
πέτρινος	πετριν	adj-ος
πέφτω	πεφτ	verb-a
πίεση	πιεση	noun-fem-η
πίθηκος	πιθηκ	noun-masc-ος
πίσω	πίσω	adv
πίτσα	πιτσ	noun-fem-α
παίζω	παιζ	verb-a
παίρνω	παιρν	verb-a
παγιδευμένος	παγιδευμεν	verb-
παγιώνω	παγιων	verb-a
παγκόσμια	παγκόσμια	adv
παγκόσμιος	παγκοσμι	adj-ος
παγώνω	παγων	verb-a
παθητικός	παθητικ	adj-ός
παιδί	παιδί	noun
παιδεία	παιδει	noun-fem-α
παιχνίδι	παιχνιδι	noun-neut-ι
πακιστανικός	πακιστανικ	adj-ός
παλάτι	παλατι	noun-neut-ι
παλαιοχριστιανικός	παλαιοχριστιανικ	adj-ός
παλαιστίνιος	παλαιστίνιος	propn
παλαιστινιακός	παλαιστινιακ	adj-ός
παλιά	παλιά	adv
παλιός	παλι	adj-ός
πανέμορφος	πανεμορφ	adj-ος
πανίδα	πανιδ	noun-fem-α
πανεπιστήμιο	πανεπιστημι	noun-neut-ο
πανεπιστημιακός	πανεπιστημιακ	adj-ός
πανευρωπαϊκός	πανευρωπαικ	adj-ός
πανηγύρι	πανηγυρι	noun-neut-ι
πανικός	πανικ	noun-neut-ι
πανοραμικός	πανοραμικ	adj-ός
παντελής	παντελ	adj-ής
παντού	παντού	adv
πανύψηλος	πανυψηλ	adj-ος
παπούτσι	παπουτσι	noun-neut-ι
παππούς	παππούς	noun
παρά	παρά	adp
παράβαση	παραβασ	noun-fem-η
παράγοντας	παραγοντ	noun-masc-ας
παράγω	παραγ	verb-a
παράδειγμα	παραδειγμα	noun-neut-μα
παράδοση	παραδοση	noun-fem-η
παράκτιος	παρακτι	adj-ος
παράλειψη	παραλειψ	noun-fem-η
παράλληλα	παράλληλα	adv
παράλληλος	παραλληλ	adj-ος
παράλογος	παραλογ	adj-ος
παράμετρος	παραμετρ	noun-masc-ος
παράνομα	παράνομα	adv
παράνομος	παρανομ	adj-ος
παράπονο	παραπον	noun-neut-ο
παράρτημα	παραρτη	noun-neut-μα
παράταση	παρατασ	noun-fem-η
παρέλευση	παρελευσ	noun-fem-η
παρέμβαση	παρεμβασ	noun-fem-η
παρέχω	παρεχ	verb-a
παρίσταμαι	παριστ	verb-
παραίτηση	παραιτηση	noun-fem-η
παραβίαση	παραβιασ	noun-fem-η
παραβιάζω	παραβιαζ	verb-a
παραβλάπτω	παραβλαπτ	verb-a
παραγγέλλω	παραγγελλ	verb-a
παραγγελία	παραγγελι	noun-fem-α
παραγκωνίζω	παραγκωνιζ	verb-a
παραγραφή	παραγραφ	noun-fem-η
παραγωγή	παραγωγη	noun-fem-η
παραγωγικός	παραγωγικ	adj-ός
παραγωγικότητα	παραγωγικοτητ	noun-fem-α
παραγωγός	παραγωγ	noun-neut-ι
παραδέχομαι	παραδεχ	verb-παθ
παραδίνω	παραδιν	verb-a
παραθέτω	παραθετ	verb-a
παραθαλάσσιος	παραθαλασσι	adj-ος
παραιτούμαι	παραιτ	verb-
παραιτώ	παραιτ	verb-b2
παρακείμενος	παρακειμεν	adj-ος
παρακινώ	παρακιν	verb-b2
παρακμή	παρακμ	noun-fem-η
παρακολουθώ	παρακολουθ	verb-b2
παρακολούθηση	παρακολουθηση	noun-fem-η
παρακωλύω	παρακωλυ	verb-a
παραλία	παραλι	noun-fem-α
παραλαβαίνω	παραλαβαιν	verb-a
παραλείπω	παραλειπ	verb-a
παραμένω	παραμεν	verb-a
παραμελώ	παραμελ	verb-b2
παραμερίζω	παραμεριζ	verb-a
παραμικρός	παραμικρ	adj-ός
παραμυθία	παραμυθία	propn
παρανομία	παρανομι	noun-fem-α
παραπάνω	παραπάνω	adv
παραπέμπω	παραπεμ	verb-a
παραπέρα	παραπέρα	adv
παρασκευάζω	παρασκευαζ	verb-a
παρασκευή	παρασκευ	noun-fem-η
παρατήρηση	παρατηρησ	noun-fem-η
παρατηρητής	παρατηρητ	noun-masc-ης
παρατηρούμενος	παρατηρουμεν	adj-ος
παρατηρώ	παρατηρ	verb-b2
παρατυπία	παρατυπι	noun-fem-α
παραφθορά	παραφθορά	noun
παραχαράκτης	παραχαρακτ	noun-masc-ης
παραχωρώ	παραχωρ	verb-b2
παραχώρηση	παραχωρησ	noun-fem-η
παραϊατρικός	παραιατρικ	adj-ός
παρελθόν	παρελθόν	noun
παρεμποδίζω	παρεμποδιζ	verb-a
παρεμφερής	παρεμφερ	adj-ής
παρευρίσκομαι	παρευρ	verb-παθ
παροικία	παροικι	noun-fem-α
παρουσία	παρουσι	noun-fem-α
παρουσίαση	παρουσιασ	noun-fem-η
παρουσιάζω	παρουσια	verb-a
παροχή	παροχη	noun-fem-η
παρτίδα	παρτιδ	noun-fem-α
παρόλα	παρόλα	adv
παρόλο	παρόλο	adv
παρόμοια	παρόμοια	adv
παρόμοιος	παρομοι	adj-ος
παρόν	παρόν	noun
παρών	παρών	adj
πας	πας	adj
πασάς	πασάς	noun
πασίγνωστος	πασιγνωστ	adj-ος
πατάτα	πατατα	noun-fem-α
πατατοπαραγωγοί	πατατοπαραγωγοί	noun
πατατοπαραγωγός	πατατοπαραγωγ	noun-neut-ι
πατρίδα	πατριδ	noun-fem-α
παύση	παυσ	noun-fem-η
παύω	παυ	verb-a
πείθω	πειθ	verb-a
πείνα	πεινα	noun-fem-α
πείρα	πειρ	noun-fem-α
πείραμα	πειρα	noun-neut-μα
πεδίο	πεδι	noun-neut-ο
πεδιάδα	πεδιαδ	noun-fem-α
πεθαίνω	πεθα	verb-a
πειρασμός	πειρασμ	noun-neut-ι
πειρατικός	πειρατικ	adj-ός
πειστικός	πειστικ	adj-ός
πελάτης	πελατ	noun-masc-ης
πελοποννησιακός	πελοποννησιακο	adj-ός
πενήντα	πενήντα	num
πεντάγωνος	πενταγωνο	adj-ος
πεντάμηνος	πενταμην	adj-ος
πεντακάθαρος	πεντακαθαρ	adj-ος
πεποίθηση	πεποιθησ	noun-fem-η
περί	περί	adp
περίεργος	περιεργ	adj-ος
περίθαλψη	περιθαλψ	noun-fem-η
περίοδος	περιοδο	noun-masc-ος
περίπατος	περιπατ	noun-masc-ος
περίπλοκος	περιπλοκ	adj-ος
περίπου	περίπου	adv
περίπτωση	περιπτωσ	noun-fem-η
περίσταση	περιστασ	noun-fem-η
περίχωρα	περιχωρ	noun-fem-α
περαιτέρω	περαιτέρω	adv
περασμένος	περασμεν	adj-ος
περιέρχομαι	περι	verb-παθ
περιέχω	περιεχ	verb-a
περιβάλλον	περιβάλλον	noun
περιβάλλω	περιβαλλ	verb-a
περιβάλλων	περιβάλλων	adj
περιβαλλοντικός	περιβαλλοντικ	adj-ός
περιβόητος	περιβοητ	adj-ος
περιγράφω	περιγραφ	verb-a
περιεκτικός	περιεκτικ	adj-ός
περιεχόμενο	περιεχομενο	noun-neut-ο
περιθωριοποιώ	περιθωριοποι	verb-b2
περιθώριο	περιθωρ	noun-neut-ο
περικοπή	περικοπ	noun-fem-η
περικόβω	περικοβ	verb-a
περιλαμβάνω	περιλ	verb-a
περιμένω	περιμεν	verb-a
περιοδεύω	περιοδευ	verb-a
περιορίζω	περιορι	verb-a
περιορισμός	περιορισμο	noun-neut-ι
περιοριστικός	περιοριστικ	adj-ός
περιουσία	περιουσι	noun-fem-α
περιοχή	περιοχ	noun-fem-η
περιπέτεια	περιπετει	noun-fem-α
περιπολώ	περιπολ	verb-b2
περιπτώσει	περιπτωσει	noun-neut-ι
περιστέρα	περιστέρα	propn
περιστατικό	περιστατικ	noun-neut-ο
περιστοιχίζω	περιστοιχιζ	verb-a
περιφέρεια	περιφερει	noun-fem-α
περιφερειακός	περιφερειακ	adj-ός
περνώ	περν	verb-b2
περπατώ	περπατ	verb-b2
περσινός	περσιν	adj-ός
πετάλι	πετάλι	propn
πετρέλαιο	πετρελαιο	noun-neut-ο
πετυχαίνω	πετυχ	verb-a
πετώ	πετ	verb-b2
πεύκο	πευκ	noun-neut-ο
πηγάζω	πηγαζ	verb-a
πηγή	πηγ	noun-fem-η
πηγαίνω	πηγαιν	verb-a
πηδάλιο	πηδαλ	noun-neut-ο
πιάνω	πιαν	verb-a
πιέζω	πιεζ	verb-a
πια	πια	adv
πιθανολογώ	πιθανολογ	verb-b2
πιθανός	πιθαν	adj-ός
πιθανότητα	πιθανοτητ	noun-fem-α
πιθανώς	πιθανώς	adv
πιο	πιο	adv
πιπέρι	πιπερι	noun-neut-ι
πισίνα	πισίνα	propn
πιστεύεται	πιστευεται	verb-παθ
πιστεύω	πιστε	verb-a
πιστοποιητικό	πιστοποιητικο	noun-neut-ο
πιστός	πιστ	adj-ός
πλάι	πλάι	adv
πλάτος	πλατ	noun-masc-ος
πλέκω	πλεκ	verb-a
πλέον	πλέον	adv
πλήγμα	πληγ	noun-neut-μα
πλήθος	πληθ	noun-masc-ος
πλήρης	πληρ	adj-ης
πλήρωμα	πληρω	noun-neut-μα
πλήρως	πλήρως	adv
πλήττω	πληττ	verb-a
πλαίσιο	πλαισι	noun-neut-ο
πλατεία	πλατει	noun-fem-α
πλειοψηφία	πλειοψηφια	noun-fem-α
πλεονέκτημα	πλεονεκτημα	noun-neut-μα
πλευρά	πλευρά	noun
πλευρό	πλευρ	noun-neut-ο
πληγείς	πληγείς	adj
πληθυσμιακός	πληθυσμιακ	adj-ός
πληθυσμός	πληθυσμο	noun-neut-ι
πληθωρισμός	πληθωρισμ	noun-neut-ι
πλημμελειοδίκης	πλημμελειοδικ	noun-masc-ης
πλην	πλην	cconj
πληροφορία	πληροφορι	noun-fem-α
πληροφόρηση	πληροφορησ	noun-fem-η
πληρωμή	πληρωμ	noun-fem-η
πληρώ	πληρ	verb-b2
πληρώνω	πληρω	verb-a
πλησίον	πλησίον	adv
πλησιάζω	πλησιαζ	verb-a
πλοίο	πλοι	noun-neut-ο
πλουραλισμός	πλουραλισμ	noun-neut-ι
πλουραλιστικός	πλουραλιστικ	adj-ός
πλούσιος	πλουσι	adj-ος
πνίγω	πνιγ	verb-a
πνεύμα	πνευ	noun-neut-μα
πνεύμονας	πνευμον	noun-masc-ας
ποίηση	ποιησ	noun-fem-η
ποδηλασία	ποδηλασια	noun-fem-α
ποιητής	ποιητ	noun-masc-ης
ποικίλλω	ποικιλλ	verb-a
ποικίλος	ποικιλ	adj-ος
ποινή	ποιν	noun-fem-η
ποινικός	ποινικ	adj-ός
ποιος	ποι	pron-masc-ος
ποιοτικός	ποιοτικ	adj-ός
ποιότητα	ποιοτητ	noun-fem-α
πολίτευμα	πολιτευ	noun-neut-μα
πολίτης	πολιτ	noun-masc-ης
πολεμίστρα	πολεμιστρ	noun-fem-α
πολεμικός	πολεμικ	adj-ός
πολιορκία	πολιορκι	noun-fem-α
πολιούχος	πολιουχ	adj-ος
πολιτεία	πολιτει	noun-fem-α
πολιτειακός	πολιτειακ	adj-ός
πολιτική	πολιτικ	noun-fem-η
πολιτικός	πολιτικ	adj-ός
πολιτιστικός	πολιτιστικ	adj-ός
πολυάριθμος	πολυαριθμ	adj-ος
πολυετής	πολυετ	adj-ής
πολύ	πολύ	adv
πολύπλευρος	πολυπλευρ	adj-ος
πολύπλοκος	πολυπλοκ	adj-ος
πολύς	π	adj-ύς
πολύχρωμος	πολυχρωμ	adj-ος
ποντάρω	πονταρ	verb-a
ποντίκι	ποντικι	noun-neut-ι
πορεία	πορεια	noun-fem-α
ποσειδώνιος	ποσειδωνι	adj-ος
ποσοστιαίος	ποσοστιαι	adj-ος
ποσοστό	ποσοστ	noun-neut-ο
ποσό	ποσ	noun-neut-ο
ποσότητα	ποσοτητ	noun-fem-α
ποτάμι	ποταμι	noun-neut-ι
ποτέ	ποτέ	adv
ποταμός	ποταμο	noun-neut-ι
που	που	pron
πουλί	πουλί	noun
πουλερικό	πουλερικ	noun-neut-ο
πουλώ	πουλ	verb-b2
πού	πού	adv
πράγμα	πραγμα	noun-neut-μα
πράγματι	πράγματι	adv
πράκτορας	πρακτορ	noun-masc-ας
πράξη	πραξ	noun-fem-η
πράσινο	πρασιν	noun-neut-ο
πράσινος	πρασιν	adj-ος
πράττω	πραττ	verb-a
πρέπει	πρέπει	aux
πρέσβης	πρεσβ	noun-masc-ης
πρίγκηπας	πριγκηπ	noun-masc-ας
πρίγκιπας	πριγκιπα	noun-masc-ας
πρίσμα	πρισ	noun-neut-μα
πραγμάτωση	πραγματωσ	noun-fem-η
πραγματικά	πραγματικά	adv
πραγματικός	πραγματικ	adj-ός
πραγματικότητα	πραγματικοτητ	noun-fem-α
πραγματοποίηση	πραγματοποιησ	noun-fem-η
πραγματοποιώ	πραγματοποι	verb-b2
πρακτική	πρακτικ	noun-fem-η
πρακτικός	πρακτικ	adj-ός
πρακτορεία	πρακτορει	noun-fem-α
πρακτορείο	πρακτορει	noun-neut-ο
πριν	πριν	adv
προ	προ	adp
προάγω	προαγ	verb-a
προάσπιση	προασπισ	noun-fem-η
προέλευση	προελευσ	noun-fem-η
προέρχομαι	προερχ	verb-παθ
προαναφερθείς	προαναφερθείς	adj
προβάλλω	προβαλλ	verb-a
προβαίνω	προβαιν	verb-a
προβλέπω	προβλε	verb-a
προβληματικός	προβληματικ	adj-ός
προβληματισμός	προβληματισμο	noun-neut-ι
προγραμματίζω	προγραμματιζ	verb-a
προγραμματικός	προγραμματικ	adj-ός
προγραμματισμένος	προγραμματισμεν	verb-
προδιαγραφή	προδιαγραφ	noun-fem-η
προδικάζω	προδικαζ	verb-a
προδικαστικός	προδικαστικ	adj-ός
προδοσία	προδοσι	noun-fem-α
προεδρία	προεδρια	noun-fem-α
προεδρείο	προεδρει	noun-neut-ο
προεδρεύων	προεδρεύων	noun
προεδρικός	προεδρικ	adj-ός
προειδοποίηση	προειδοποιηση	noun-fem-η
προειδοποιητικός	προειδοποιητικ	adj-ός
προειδοποιώ	προειδοποι	verb-b2
προεκλογικός	προεκλογικ	adj-ός
προενταξιακή	προενταξιακή	adj
προεξάρχων	προεξάρχων	adj
προερχόμενος	προερχομεν	verb-
προετοιμάζω	προετοιμαζ	verb-a
προετοιμασία	προετοιμασι	noun-fem-α
προηγουμένως	προηγουμένως	adv
προηγούμαι	προηγ	verb-
προηγούμενος	προηγουμεν	adj-ος
προθεσμία	προθεσμι	noun-fem-α
προκάτοχος	προκατοχ	adj-ος
προκήρυξη	προκηρυξ	noun-fem-η
προκαθήμενος	προκαθημεν	noun-masc-ος
προκαλώ	προκ	verb-b2
προκαταβάλλω	προκατ	verb-a
προκαταρκτικός	προκαταρκτικ	adj-ός
προκείμενος	προκειμεν	adj-ος
προκειμένου	προκειμένου	sconj
προκηρύσσω	προκηρυσσ	verb-a
προκλητικός	προκλητικ	adj-ός
προκρίνω	προκριν	verb-a
προκριματικός	προκριματικ	adj-ός
προκύπτω	προκυ	verb-a
προλαβαίνω	προλαβαιν	verb-a
προμήθεια	προμηθει	noun-fem-α
προμαγειρεμένος	προμαγειρεμεν	verb-
προμηθεύω	προμηθευ	verb-a
προνόμιο	προνομ	noun-neut-ο
προξενώ	προξεν	verb-b2
προοίμιο	προοιμ	noun-neut-ο
προοδεύω	προοδευ	verb-a
προοπτική	προοπτικ	noun-fem-η
προορισμός	προορισμ	noun-neut-ι
προπάντων	προπάντων	adv
προπαγάνδα	προπαγανδ	noun-fem-α
προπαγανδιστικός	προπαγανδιστικ	adj-ός
προπαντός	προπαντός	adv
προς	προς	adp
προσάρτηση	προσαρτηση	noun-fem-η
προσέγγιση	προσεγγιση	noun-fem-η
προσέχω	προσε	verb-a
προσήκων	προσήκων	adj
προσήλωση	προσηλωσ	noun-fem-η
προσανατολίζω	προσανατολιζ	verb-a
προσαρμογή	προσαρμογ	noun-fem-η
προσαρμόζω	προσαρμοζ	verb-a
προσαρτώ	προσαρτ	verb-b2
προσβάσιμος	προσβασιμ	adj-ος
προσγείωση	προσγειωσ	noun-fem-η
προσδίδω	προσδιδ	verb-a
προσδιορίζω	προσδιοριζ	verb-a
προσδιορισμός	προσδιορισμ	noun-neut-ι
προσδοκία	προσδοκι	noun-fem-α
προσδόκιμος	προσδοκιμ	adj-ος
προσεγγίζω	προσεγγι	verb-a
προσελκύω	προσελκυ	verb-a
προσεύχομαι	προσευχ	verb-παθ
προσθέτω	προσ	verb-a
προσκαλώ	προσκαλ	verb-b2
προσλαμβάνω	προσλ	verb-a
προσοχή	προσοχ	noun-fem-η
προσπάθεια	προσπαθει	noun-fem-α
προσπαθώ	προσπαθ	verb-b2
προσπερνώ	προσπερν	verb-b2
προστάτιδα	προστάτιδα	adj
προστασία	προστασι	noun-fem-α
προστατευόμενος	προστατευομεν	adj-ος
προστατεύω	προστατε	verb-a
προστιθέμενος	προστιθεμεν	adj-ος
προσυπογράφω	προσυπογραφ	verb-a
προσφέρω	προσφερ	verb-a
προσφέρων	προσφέρων	adj
προσφορά	προσφορά	noun
προσχωρώ	προσχωρ	verb-b2
προσχώρηση	προσχωρησ	noun-fem-η
προσωπικά	προσωπικά	adv
προσωπικό	προσωπικ	noun-neut-ο
προσωπικός	προσωπικ	adj-ός
προσωπικότητα	προσωπικοτητ	noun-fem-α
προσωρινά	προσωρινά	adv
προσωρινός	προσωριν	adj-ός
προσόν	προσόν	noun
προτέρημα	προτερη	noun-neut-μα
προτίθεμαι	προτιθε	verb-
προτίμηση	προτιμησ	noun-fem-η
προτείνω	προτ	verb-a
προτεινόμενος	προτεινομεν	adj-ος
προτεραιότητα	προτεραιοτητ	noun-fem-α
προτιμώ	προτιμ	verb-b2
προτρέπω	προτρεπ	verb-a
προφανώς	προφανώς	adv
προφορικά	προφορικά	adv
προφορικός	προφορικ	adj-ός
προχωρώ	προχωρ	verb-b2
προωθώ	προωθ	verb-b2
προϊόν	προϊόν	noun
προϋποθέτω	προυποθετ	verb-a
προϋπολογισμός	προυπολογισμ	noun-neut-ι
προϋπόθεση	προυποθεσ	noun-fem-η
προώθηση	προωθηση	noun-fem-η
πρωί	πρωί	noun
πρωθυπουργός	πρωθυπουργο	noun-neut-ι
πρωταρχικός	πρωταρχικ	adj-ός
πρωτεύουσα	πρωτευουσ	noun-fem-α
πρωτοβάθμιος	πρωτοβαθμι	adj-ος
πρωτοβουλία	πρωτοβουλι	noun-fem-α
πρωτοκατοικώ	πρωτοκατοικ	verb-b2
πρωτοπόρος	πρωτοπορ	adj-ος
πρωτοστατώ	πρωτοστατ	verb-b2
πρωτοσύγγελος	πρωτοσυγγελ	noun-masc-ος
πρωτόκολλο	πρωτοκολλ	noun-neut-ο
πρόβλεψη	προβλεψ	noun-fem-η
πρόβλημα	προβλημα	noun-neut-μα
πρόγραμμα	προγραμμα	noun-neut-μα
πρόεδρος	προεδρ	noun-masc-ος
πρόθεση	προθεσ	noun-fem-η
πρόθυμος	προθυμ	adj-ος
πρόκειται		verb-παθ
πρόκληση	προκληση	noun-fem-η
πρόκριση	προκρισ	noun-fem-η
πρόκριτος	προκριτ	noun-masc-ος
πρόληψη	προληψ	noun-fem-η
πρόνοια	προνοι	noun-fem-α
πρόοδος	προοδο	noun-masc-ος
πρόσβαση	προσβαση	noun-fem-η
πρόσθετος	προσθετ	adj-ος
πρόσκληση	προσκλησ	noun-fem-η
πρόστιμο	προστιμ	noun-neut-ο
πρόσφατα	πρόσφατα	adv
πρόσφατος	προσφατ	adj-ος
πρόσφυγας	προσφυγ	noun-masc-ας
πρόσωπο	προσωπ	noun-neut-ο
πρόταση	προτασ	noun-fem-η
πρότινος	πρότινος	adv
πρότυπο	προτυπ	noun-neut-ο
πρώην	πρώην	adv
πρώτα	πρώτα	adj
πρώτιστα	πρώτιστα	adv
πρώτον	πρώτον	adv
πρώτος	πρωτ	adj-ος
πτέρυγα	πτερυγ	noun-fem-α
πτήση	πτησ	noun-fem-η
πτηνό	πτην	noun-neut-ο
πτοώ	πτο	verb-b2
πτυχή	πτυχ	noun-fem-η
πτώμα	πτω	noun-neut-μα
πτώση	πτωσ	noun-fem-η
πτώχευση	πτωχευσ	noun-fem-η
πυλώνας	πυλων	noun-masc-ας
πυρ	πυρ	noun
πυρήνας	πυρην	noun-masc-ας
πυρηνικός	πυρηνικ	adj-ός
πυριτιδαποθήκη	πυριτιδαποθηκ	noun-fem-η
πυροβόλο	πυροβολ	noun-neut-ο
πυροδοτώ	πυροδοτ	verb-b2
πυροσβέστης	πυροσβεστ	noun-masc-ης
πωλώ	πωλ	verb-b2
πως	πως	sconj
πόδι	ποδι	noun-neut-ι
πόλεμος	πολεμο	noun-masc-ος
πόλη	πολ	noun-fem-η
πόλος	πολ	noun-masc-ος
πόρος	πορ	noun-masc-ος
πόσο	πόσο	adv
πότε	πότε	adv
πύλη	πυλ	noun-fem-η
πύραυλος	πυραυλ	noun-masc-ος
πώληση	πωλησ	noun-fem-η
πώς	πώς	adv
ρήτρα	ρητρ	noun-fem-α
ρίχνω	ριχν	verb-a
ρίχτερ	ρίχτερ	noun
ραδιοφωνία	ραδιοφωνι	noun-fem-α
ραντάρ	ραντάρ	noun
ρεκόρ	ρεκόρ	noun
ρεπουμπλικανικός	ρεπουμπλικανικ	adj-ός
ρεπουμπλικανός	ρεπουμπλικαν	noun-neut-ι
ρευστός	ρευστ	adj-ός
ρευστότητα	ρευστοτητ	noun-fem-α
ρεύμα	ρευ	noun-neut-μα
ρητά	ρητά	adv
ρητός	ρητ	adj-ός
ρητώς	ρητώς	adv
ροή	ρο	noun-fem-η
ρουκέτα	ρουκετ	noun-fem-α
ρούβλι	ρουβλι	noun-neut-ι
ρούβλιων	ρούβλιων	noun
ρυθμίζω	ρυθμιζ	verb-a
ρυθμιστικός	ρυθμιστικ	adj-ός
ρυθμός	ρυθμο	noun-neut-ι
ρυπογόνος	ρυπογον	adj-ος
ρωμαϊκός	ρωμαικ	adj-ός
ρωσικός	ρωσικ	adj-ός
ρωτώ	ρωτ	verb-b2
ρόλος	ρολο	noun-masc-ος
ρύθμιση	ρυθμισ	noun-fem-η
ρύπανση	ρυπανση	noun-fem-η
σ	σ	adp
σάλος	σαλ	noun-masc-ος
σάλτσα	σαλτσ	noun-fem-α
σέβομαι	σεβ	verb-παθ
σήμα	ση	noun-neut-μα
σήμερα	σήμερα	adv
σίγουρα	σίγουρα	adv
σίφωνας	σιφων	noun-masc-ας
σαν	σαν	adv
σαφήνεια	σαφηνει	noun-fem-α
σαφής	σαφ	adj-ής
σαφώς	σαφώς	adv
σβήνω	σβην	verb-a
σε	σε	adp
σείω	σει	verb-a
σεβασμός	σεβασμο	noun-neut-ι
σειρά	σειρά	noun
σεισμόπληκτος	σεισμοπληκτ	adj-ος
σεισμός	σεισμο	noun-neut-ι
σελίδα	σελιδ	noun-fem-α
σημάδι	σημαδι	noun-neut-ι
σημαία	σημαι	noun-fem-α
σημαίνω	σημα	verb-a
σημαντικά	σημαντικά	adv
σημαντικός	σημαντικ	adj-ός
σημαντικότητα	σημαντικοτητ	noun-fem-α
σημασία	σημασια	noun-fem-α
σημείο	σημει	noun-neut-ο
σημειωθείσα	σημειωθείσα	adj
σημειώνω	σημειω	verb-a
σημερινός	σημεριν	adj-ός
σθεναρά	σθεναρά	adv
σιδηροδρομικός	σιδηροδρομικ	adj-ός
σιδηρόδρομος	σιδηροδρομ	noun-masc-ος
σιντριβάνι	σιντριβανι	noun-neut-ι
σκάνδαλο	σκανδαλ	noun-neut-ο
σκάφος	σκαφ	noun-masc-ος
σκέφτομαι	σκεφτ	verb-παθ
σκέψη	σκεψ	noun-fem-η
σκήνωμα	σκηνω	noun-neut-μα
σκεύος	σκευ	noun-masc-ος
σκληρά	σκληρά	adv
σκληρός	σκληρ	adj-ός
σκοπεύω	σκοπευ	verb-a
σκοπός	σκοπο	noun-neut-ι
σκορ	σκορ	noun
σκοράρω	σκοραρ	verb-a
σκορπίζω	σκορπιζ	verb-a
σκοτώνω	σκοτω	verb-a
σκόνη	σκον	noun-fem-η
σλαβικός	σλαβικ	adj-ός
σλαβομακεδονικός	σλαβομακεδονικ	adj-ός
σλαβόφωνος	σλαβοφωνο	adj-ος
σλόγκαν	σλόγκαν	noun
σοβαρά	σοβαρά	adv
σοβαρός	σοβαρ	adj-ός
σοβαρότητα	σοβαροτητα	noun-fem-α
σοβιετικός	σοβιετικ	adj-ός
σοκ	σοκ	noun
σοκάκι	σοκακι	noun-neut-ι
σος	σ	noun-masc-ος
σοσιαλιστής	σοσιαλιστ	noun-masc-ης
σουλτάνος	σουλταν	noun-masc-ος
σουνίτης	σουνιτ	noun-masc-ης
σουνιτικός	σουνιτικ	adj-ός
σούπα	σουπ	noun-fem-α
σπάνια	σπάνια	adj
σπάνιος	σπανι	adj-ος
σπάω	σπ	verb-b1
σπέρνω	σπερν	verb-a
σπίτι	σπιτι	noun-neut-ι
σπανίζω	σπανιζ	verb-a
σπεύδω	σπευδ	verb-a
σπορ	σπορ	noun
σπουδαιότητα	σπουδαιοτητ	noun-fem-α
σπυρίς	σπυρίς	propn
στ'	στ'	adp
στάδιο	σταδ	noun-neut-ο
στάση	σταση	noun-fem-η
στέκω	στεκ	verb-a
στέλεχος	στελεχ	noun-masc-ος
στέλνω	στελν	verb-a
στέμμα	στεμ	noun-neut-μα
στήριγμα	στηριγ	noun-neut-μα
στήριξη	στηριξη	noun-fem-η
στα	στα	adp+det
σταδιακά	σταδιακά	adv
σταδιακός	σταδιακ	adj-ός
σταθεροποιώ	σταθεροποι	verb-b2
σταθερός	σταθερ	adj-ός
σταθερότητα	σταθεροτητα	noun-fem-α
σταθμεύω	σταθμευ	verb-a
σταθμός	σταθμο	noun-neut-ι
σταματώ	σταματ	verb-b2
στατιστικός	στατιστικ	adj-ός
σταυροειδής	σταυροειδ	adj-ής
σταυρός	σταυρός	propn
στεγάζω	στεγαζ	verb-a
στενά	στενά	noun
στενός	στεν	adj-ός
στη	στη	adp+det
στην	στην	adp+det
στηρίζω	στηριζ	verb-a
στηριζόμενος	στηριζομεν	verb-
στιγμή	στιγμ	noun-fem-η
στις	στις	adp+det
στο	στο	adp+det
στοιχίζω	στοιχιζ	verb-a
στοιχείο	στοιχει	noun-neut-ο
στον	στον	adp+det
στους	στους	adp+det
στοχεία	στοχει	noun-fem-α
στοχοθεσία	στοχοθεσι	noun-fem-α
στράτευμα	στρατευμα	noun-neut-μα
στρέβλωση	στρεβλωσ	noun-fem-η
στρέφω	στρεφ	verb-a
στρατηγική	στρατηγικη	noun-fem-η
στρατηγικός	στρατηγικ	adj-ός
στρατηγός	στρατηγ	noun-neut-ι
στρατιωτικά	στρατιωτικά	adv
στρατιωτικός	στρατιωτικ	adj-ός
στρατιώτης	στρατιωτ	noun-masc-ης
στρατόπεδο	στρατοπεδ	noun-neut-ο
στρατός	στρατο	noun-neut-ι
στρατώνα	στρατων	noun-fem-α
στρατώνας	στρατων	noun-masc-ας
στροφή	στροφη	noun-fem-η
στρώμα	στρω	noun-neut-μα
στόλος	στολο	noun-masc-ος
στόχαστρο	στοχαστρ	noun-neut-ο
στόχος	στοχ	noun-masc-ος
συγγένεια	συγγενει	noun-fem-α
συγγνώμη	συγγνώμη	adj
συγκέντρωση	συγκεντρωσ	noun-fem-η
συγκίνηση	συγκινησ	noun-fem-η
συγκαλώ	συγκαλ	verb-b2
συγκατάθεση	συγκαταθεσ	noun-fem-η
συγκαταλέγω	συγκαταλεγ	verb-a
συγκατηγορούμενος	συγκατηγορουμεν	noun-masc-ος
συγκεκριμένα	συγκεκριμένα	adv
συγκεκριμένος	συγκεκριμεν	adj-ος
συγκεντρωτικά	συγκεντρωτικά	adv
συγκεντρωτισμός	συγκεντρωτισμ	noun-neut-ι
συγκεντρώνω	συγκεντρω	verb-a
συγκρίνω	συγκριν	verb-a
συγκριτικά	συγκριτικά	adv
συγκροτώ	συγκροτ	verb-b2
συγκρότημα	συγκροτη	noun-neut-μα
συγκρότηση	συγκροτησ	noun-fem-η
συγκυρία	συγκυρι	noun-fem-α
συγχαίρω	συγχα	verb-a
συγχαρητήρια	συγχαρητηρια	noun-fem-α
συγχρηματοδότηση	συγχρηματοδοτησ	noun-fem-η
συζήτηση	συζητησ	noun-fem-η
συζητώ	συζητ	verb-b2
συκώτι	συκωτι	noun-neut-ι
συλλέγω	συλλεγ	verb-a
συλλαλητήριο	συλλαλητηρ	noun-neut-ο
συλλαμβάνω	συλλαμβαν	verb-a
συλληπήτηρια	συλληπητηρι	noun-fem-α
συλλογή	συλλογ	noun-fem-η
συλλογικός	συλλογικ	adj-ός
συλλυπητήριος	συλλυπητηρι	adj-ος
συμβάλλω	συμβαλλ	verb-a
συμβάν	συμβάν	noun
συμβαίνω	συμβαιν	verb-a
συμβασιούχος	συμβασιουχ	noun-masc-ος
συμβατικός	συμβατικ	adj-ός
συμβατός	συμβατ	adj-ός
συμβιβασμός	συμβιβασμο	noun-neut-ι
συμβιβαστικός	συμβιβαστικ	adj-ός
συμβολή	συμβολ	noun-fem-η
συμβούλιο	συμβουλιο	noun-neut-ο
συμμαχία	συμμαχι	noun-fem-α
συμμαχικός	συμμαχικ	adj-ός
συμμερίζομαι	συμμερι	verb-παθ
συμμετέχω	συμμετ	verb-a
συμμετέχων	συμμετέχων	adj
συμμετοχή	συμμετοχη	noun-fem-η
συμμορφώνω	συμμορφω	verb-a
συμπέρασμα	συμπερασμα	noun-neut-μα
συμπαράσταση	συμπαραστασ	noun-fem-η
συμπαρατάσσομαι	συμπαρατασσ	verb-παθ
συμπερίληψη	συμπεριληψ	noun-fem-η
συμπεριλαμβάνω	συμπεριλ	verb-a
συμπεριλαμβανόμενος	συμπεριλαμβανομεν	verb-
συμπεριφορά	συμπεριφορά	noun
συμπληρώνω	συμπληρω	verb-a
συμπλοκή	συμπλοκ	noun-fem-η
συμπολίτης	συμπολιτ	noun-masc-ης
συμφέρον	συμφέρον	noun
συμφέρων	συμφέρων	adj
συμφιλίωση	συμφιλιωσ	noun-fem-η
συμφραζόμενα	συμφραζομεν	noun-fem-α
συμφωνία	συμφωνι	noun-fem-α
συμφωνηθείς	συμφωνηθείς	adj
συμφωνώ	συμφων	verb-b2
συνάδελφος	συναδελφ	noun-masc-ος
συνάδω	συναδ	verb-a
συνάλλαγμα	συναλλαγμα	noun-neut-μα
συνάντηση	συναντησ	noun-fem-η
συνάπτω	συνα	verb-a
συνέδριο	συνεδρι	noun-neut-ο
συνέλευση	συνελευση	noun-fem-η
συνέντευξη	συνεντευξ	noun-fem-η
συνέπεια	συνεπει	noun-fem-α
συνέρχομαι	συνερχ	verb-παθ
συνέχεια	συνεχεια	noun-fem-α
συνέχιση	συνεχισ	noun-fem-η
συνήθης	συνηθ	adj-ης
συνήθως	συνήθως	adv
συναγερμός	συναγερμ	noun-neut-ι
συναθροίζεσθαι	συναθροιζεσθαι	noun-neut-ι
συνακόλουθος	συνακολουθ	adj-ος
συναλλαγή	συναλλαγ	noun-fem-η
συναντώ	συναντ	verb-b2
συναπόφαση	συναποφασ	noun-fem-η
συνασπίζεσθαι	συνασπιζεσθαι	verb-
συνασπισμός	συνασπισμο	noun-neut-ι
συναφής	συναφ	adj-ής
συνδέω	συνδ	verb-b1
συνδιάσκεψη	συνδιασκεψ	noun-fem-η
συνδιαλλαγή	συνδιαλλαγ	noun-fem-η
συνδικάτο	συνδικατ	noun-neut-ο
συνδυάζω	συνδυα	verb-a
συνδυασμός	συνδυασμ	noun-neut-ι
συνεδρίαση	συνεδριασ	noun-fem-η
συνειδητοποιώ	συνειδητοποι	verb-b2
συνεκτικός	συνεκτικ	adj-ός
συνεννόηση	συνεννοησ	noun-fem-η
συνενώνω	συνενων	verb-a
συνεπάγομαι	συνεπαγ	verb-παθ
συνεπής	συνεπ	adj-ής
συνεπώς	συνεπώς	adv
συνεργάζομαι	συνεργα	verb-παθ
συνεργάσιμος	συνεργασιμ	adj-ος
συνεργία	συνεργι	noun-fem-α
συνεργασία	συνεργασια	noun-fem-α
συνεργείο	συνεργε	noun-neut-ο
συνεταιρίζεσθαι	συνεταιριζεσθαι	noun-neut-ι
συνεχής	συνεχ	adj-ής
συνεχίζω	συνεχι	verb-a
συνεχεία	συνεχει	noun-fem-α
συνεχιζόμενος	συνεχιζομεν	adj-ος
συνεχόμενος	συνεχομεν	adj-ος
συνεχώς	συνεχώς	adv
συνηθίζω	συνηθιζ	verb-a
συνθήκη	συνθηκ	noun-fem-η
συνθετικός	συνθετικ	adj-ός
συνιστώ	συνιστ	verb-b2
συνοδευτικός	συνοδευτικ	adj-ός
συνοδευόμενος	συνοδευομεν	adj-ος
συνοδεύω	συνοδευ	verb-a
συνοδός	συνοδ	noun-neut-ι
συνοικία	συνοικι	noun-fem-α
συνολικά	συνολικά	adv
συνομιλία	συνομιλι	noun-fem-α
συνομιλητής	συνομιλητ	noun-masc-ης
συνομιλώ	συνομιλ	verb-b2
συνοπτικά	συνοπτικά	adv
συνοριακός	συνοριακ	adj-ός
συνοχή	συνοχ	noun-fem-η
συνοψίζω	συνοψι	verb-a
συντάκτης	συντακτ	noun-masc-ης
συντάσσω	συντασσ	verb-a
συνταγματάρχης	συνταγματαρχ	noun-masc-ης
συνταγματικός	συνταγματικ	adj-ός
συνταγματοποίηση	συνταγματοποιησ	noun-fem-η
συντακτικός	συντακτικ	adj-ός
συνταξιοδότηση	συνταξιοδοτησ	noun-fem-η
συντελώ	συντελ	verb-b2
συντηρητικός	συντηρητικ	adj-ός
συντομία	συντομι	noun-fem-α
συντονίζω	συντονιζ	verb-a
συντονισμός	συντονισμο	noun-neut-ι
συντονιστής	συντονιστ	noun-masc-ης
συντριπτικός	συντριπτικ	adj-ός
συνωμοσία	συνωμοσι	noun-fem-α
συνόψιση	συνοψισ	noun-fem-η
συνύπαρξη	συνυπαρξ	noun-fem-η
συριακός	συριακ	adj-ός
συσπειρώνω	συσπειρων	verb-a
συστήνω	συστην	verb-a
συστοιχία	συστοιχι	noun-fem-α
συσχετισμός	συσχετισμ	noun-neut-ι
συχνά	συχνά	adv
συχνότητα	συχνοτητ	noun-fem-α
σφάλμα	σφαλ	noun-neut-μα
σφαγή	σφαγ	noun-fem-η
σφαιρικός	σφαιρικ	adj-ός
σφραγίδα	σφραγιδ	noun-fem-α
σφυγμομέτρηση	σφυγμομετρησ	noun-fem-η
σχέδιο	σχεδι	noun-neut-ο
σχέση	σχεσ	noun-fem-η
σχήμα	σχη	noun-neut-μα
σχεδιάζω	σχεδια	verb-a
σχεδιασμός	σχεδιασμ	noun-neut-ι
σχεδόν	σχεδόν	adv
σχετίζω	σχετιζ	verb-a
σχετικά	σχετικά	adv
σχετικός	σχετικ	adj-ός
σχηματίζω	σχηματι	verb-a
σχηματισμός	σχηματισμο	noun-neut-ι
σχολείο	σχολει	noun-neut-ο
σχολιάζω	σχολιαζ	verb-a
σχολιασμός	σχολιασμ	noun-neut-ι
σχολικός	σχολικ	adj-ός
σχόλιο	σχολ	noun-neut-ο
σωματίδιο	σωματιδ	noun-neut-ο
σωματικός	σωματικ	adj-ός
σωρεία	σωρει	noun-fem-α
σωστά	σωστά	adv
σωστικός	σωστικ	adj-ός
σωστός	σωστ	adj-ός
σύγκληση	συγκλησ	noun-fem-η
σύγκριση	συγκρισ	noun-fem-η
σύγκρουση	συγκρουσ	noun-fem-η
σύγχρονος	συγχρον	adj-ος
σύγχυση	συγχυσ	noun-fem-η
σύζυγος	συζυγ	noun-masc-ος
σύλληψη	συλληψ	noun-fem-η
σύλλογος	συλλογ	noun-masc-ος
σύμβαση	συμβασ	noun-fem-η
σύμβολο	συμβολ	noun-neut-ο
σύμβουλος	συμβουλ	noun-masc-ος
σύμμαχος	συμμαχ	noun-masc-ος
σύμπαν	σύμπαν	adj
σύμπλεγμα	συμπλεγ	noun-neut-μα
σύμφωνα	σύμφωνα	adv
σύμφωνο	συμφων	noun-neut-ο
σύμφωνος	συμφων	adj-ος
σύναψη	συναψ	noun-fem-η
σύνδεση	συνδεσ	noun-fem-η
σύνθεση	συνθεσ	noun-fem-η
σύνθετος	συνθετ	adj-ος
σύνοδος	συνοδο	noun-masc-ος
σύνολο	συνολο	noun-neut-ο
σύνορο	συνορ	noun-neut-ο
σύνταγμα	συνταγμα	noun-neut-μα
σύνταξη	συνταξ	noun-fem-η
σύντομα	σύντομα	adv
σύντομος	συντομ	adj-ος
σύρω	συρ	verb-a
σύσταση	συστασ	noun-fem-η
σύστημα	συστημα	noun-neut-μα
σώζω	σωζ	verb-a
σώμα	σωμα	noun-neut-μα
τάγμα	ταγ	noun-neut-μα
τάξη	ταξ	noun-fem-η
τάση	τασ	noun-fem-η
τάσσω	τασσ	verb-a
τάφος	ταφ	noun-masc-ος
τέλειος	τελει	adj-ος
τέλος	τελ	noun-masc-ος
τέμενος	τεμεν	noun-masc-ος
τέμπλο	τεμπλ	noun-neut-ο
τένις	τένις	noun
τέρμα	τερμα	noun-neut-μα
τέσσερις	τέσσερις	num
τέταρτος	τέταρτος	adv
τέτοιος	τέτοιος	det
τέχνη	τεχν	noun-fem-η
τήρηση	τηρησ	noun-fem-η
τίμημα	τιμη	noun-neut-μα
τίνος	τιν	pron-masc-ος
τίποτα	τιποτ	pron-fem-α
ταβέρνα	ταβερν	noun-fem-α
ταβερνάκι	ταβερνακι	noun-neut-ι
τακτικός	τακτικ	adj-ός
τακτός	τακτ	adj-ός
ταμειακός	ταμειακ	adj-ός
ταξίδι	ταξιδι	noun-neut-ι
ταξιδεύω	ταξιδε	verb-a
ταπεινός	ταπειν	adj-ός
ταράτσα	ταρατσ	noun-fem-α
ταυτίζω	ταυτιζ	verb-a
ταυτόσημος	ταυτοσημ	adj-ος
ταυτότητα	ταυτοτητ	noun-fem-α
ταυτόχρονα	ταυτόχρονα	adv
ταχέως	ταχέως	adv
ταχυγράφος	ταχυγραφ	noun-masc-ος
ταχυδρομείο	ταχυδρομε	noun-neut-ο
ταχύς	ταχ	adj-ύς
ταχύτητα	ταχυτητ	noun-fem-α
ταύτα	ταυτ	pron-fem-α
ταύτιση	ταυτισ	noun-fem-η
τείχος	τειχ	noun-masc-ος
τεθωρακισμένος	τεθωρακισμεν	adj-ος
τεκμήριο	τεκμηρ	noun-neut-ο
τελείως	τελείως	adv
τελειώνω	τελειω	verb-a
τελεσίδικος	τελεσιδικ	adj-ος
τελευταία	τελευταία	adv
τελευταίος	τελευται	adj-ος
τελικά	τελικά	adv
τελικός	τελικ	adj-ός
τελώ	τελ	verb-b2
τεράστιος	τεραστι	adj-ος
τερματισμός	τερματισμ	noun-neut-ι
τετραήμερος	τετραημερ	adj-ος
τετραγωνικός	τετραγωνικ	adj-ός
τετρακίονος	τετρακιον	adj-ος
τετραμελής	τετραμελ	adj-ής
τεχνικά	τεχνικά	adv
τεχνικός	τεχνικ	adj-ός
τεχνολογικός	τεχνολογικ	adj-ός
τεύχος	τευχ	noun-masc-ος
τζαμί	τζαμί	noun
τηλεγράφημα	τηλεγραφη	noun-neut-μα
τηλεοπτικός	τηλεοπτικ	adj-ός
τηλεπικοινωνία	τηλεπικοινωνι	noun-fem-α
τηλεφωνικά	τηλεφωνικά	adv
τηλεφωνώ	τηλεφων	verb-b2
τηλεόραση	τηλεοραση	noun-fem-η
τηρώ	τηρ	verb-b2
τι	τι	pron-neut-ι
τιμή	τιμ	noun-fem-η
τιμητικός	τιμητικ	adj-ός
τιμολογώ	τιμολογ	verb-b2
τμήμα	τμημα	noun-neut-μα
τοιχογραφία	τοιχογραφι	noun-fem-α
τομέας	τομε	noun-masc-ας
τομή	τομ	noun-fem-η
τομεακός	τομεακ	adj-ός
τονίζω	τονι	verb-a
τοπίο	τοπιο	noun-neut-ο
τοπικός	τοπικ	adj-ός
τοπωνύμιο	τοπωνυμ	noun-neut-ο
τουλάχιστο	τουλάχιστο	adv
τουρίστας	τουριστ	noun-masc-ας
τουρισμός	τουρισμο	noun-neut-ι
τουριστικός	τουριστικ	adj-ός
τουρκικός	τουρκικ	adj-ός
τουρκοκρατία	τουρκοκρατια	noun-fem-α
τουρκοκυπριακός	τουρκοκυπριακ	adj-ός
τούνελ	τούνελ	noun
τούτος	τουτο	pron-masc-ος
τράπεζα	τραπεζ	noun-fem-α
τρένο	τρεν	noun-neut-ο
τρέφω	τρεφ	verb-a
τρέχων	τρέχων	adj
τρίμηνος	τριμην	adj-ος
τρίτος	τριτ	adj-ος
τραβώ	τραβ	verb-b2
τραγικός	τραγικ	adj-ός
τραπεζικός	τραπεζικ	adj-ός
τραπουλόχαρτο	τραπουλοχαρτ	noun-neut-ο
τραυματίας	τραυματι	noun-masc-ας
τραυματίζω	τραυματι	verb-a
τραύμα	τραυ	noun-neut-μα
τρείς	τρείς	num
τρεις	τρεις	num
τριάδα	τριαδ	noun-fem-α
τριήμερο	τριημερ	noun-neut-ο
τριπλάσιος	τριπλασι	adj-ος
τρομαγμένος	τρομαγμεν	adj-ος
τρομερός	τρομερ	adj-ός
τρομοκράτης	τρομοκρατ	noun-masc-ης
τρομοκρατία	τρομοκρατια	noun-fem-α
τρομοκρατικός	τρομοκρατικ	adj-ός
τροπολογία	τροπολογι	noun-fem-α
τροποποίηση	τροποποιησ	noun-fem-η
τροποποιώ	τροποποι	verb-b2
τρούλλος	τρουλλ	noun-masc-ος
τρόικα	τροικα	noun-fem-α
τρόπος	τροπ	noun-masc-ος
τρόφιμα	τροφιμ	noun-neut-μα
τρώω	τρω	verb-a
τσίλι	τσιλι	noun-neut-ι
τσικνιάς	τσικνιάς	noun
τυποποιώ	τυποποι	verb-b2
τυχαίνω	τυχαιν	verb-a
τόκος	τοκ	noun-masc-ος
τόνος	τονο	noun-masc-ος
τόπος	τοπο	noun-masc-ος
τόσο	τόσο	adv
τότε	τότε	adv
τύπος	τυπο	noun-masc-ος
τύχη	τυχ	noun-fem-η
τώρα	τώρα	adv
υγεία	υγεια	noun-fem-α
υγειονομικός	υγειονομικ	adj-ός
υγιής	υγι	adj-ής
υδραγωγείο	υδραγωγε	noun-neut-ο
υδροβιότοπος	υδροβιοτοπ	noun-masc-ος
υδρολογικός	υδρολογικ	adj-ός
υιοθέτηση	υιοθετησ	noun-fem-η
υιοθετώ	υιοθετ	verb-b2
υλικό	υλικ	noun-neut-ο
υλοποίηση	υλοποιησ	noun-fem-η
υλοποιώ	υλοποι	verb-b2
υπάγω	υπαγ	verb-a
υπάλληλος	υπαλληλ	noun-masc-ος
υπάρχω	υπαρχ	verb-a
υπάρχων	υπάρχων	adj
υπέρ	υπέρ	adv
υπέρμετρος	υπερμετρ	adj-ος
υπέροχος	υπεροχ	adj-ος
υπήκοος	υπηκο	noun-masc-ος
υπαγορεύω	υπαγορευ	verb-a
υπαινίσσομαι	υπαινι	verb-παθ
υπεισέρχομαι	υπεισερχ	verb-παθ
υπενθυμίζω	υπενθυμι	verb-a
υπεραγορά	υπεραγορά	noun
υπεραρκετός	υπεραρκετ	adj-ός
υπερασπίζω	υπερασπιζ	verb-a
υπερβολή	υπερβολ	noun-fem-η
υπερβολικά	υπερβολικά	adv
υπερβολικός	υπερβολικ	adj-ός
υπεργολαβικά	υπεργολαβικά	adv
υπερεκτιμώ	υπερεκτιμ	verb-b2
υπερσυντηρητικός	υπερσυντηρητικ	adj-ός
υπερψήφιση	υπερψηφισ	noun-fem-η
υπερψηφίζω	υπερψηφι	verb-a
υπευθυνότητα	υπευθυνοτητ	noun-fem-α
υπεύθυνος	υπευθυν	adj-ος
υπηκοότητα	υπηκοοτητ	noun-fem-α
υπηρεσία	υπηρεσι	noun-fem-α
υπηρεσιακός	υπηρεσιακ	adj-ός
υπνωτικός	υπνωτικ	noun-neut-ι
υποβάθμιση	υποβαθμισ	noun-fem-η
υποβάλλω	υποβαλλ	verb-a
υποβολή	υποβολη	noun-fem-η
υποβρύχιο	υποβρυχ	noun-neut-ο
υπογράφω	υπογραφ	verb-a
υπογραμμίζω	υπογραμμι	verb-a
υπογραφή	υπογραφ	noun-fem-η
υποδέχομαι	υποδεχ	verb-παθ
υποδείχνω	υποδειχν	verb-a
υποδομή	υποδομ	noun-fem-η
υποθέτω	υποθετ	verb-a
υποθετικά	υποθετικά	adv
υποκατάστατος	υποκαταστατ	noun-masc-ος
υποκινώ	υποκιν	verb-b2
υποκλέπτω	υποκλεπτ	verb-a
υπολείπομαι	υπολειπ	verb-παθ
υπολογίζω	υπολογι	verb-a
υπολογισμός	υπολογισμ	noun-neut-ι
υπολογιστής	υπολογιστ	noun-masc-ης
υπομονή	υπομον	noun-fem-η
υπονομεύω	υπονομευ	verb-a
υπονοώ	υπονο	verb-b2
υποσκάβω	υποσκαβ	verb-a
υποστήριξη	υποστηριξη	noun-fem-η
υποστηρίζω	υποστηρι	verb-a
υποστηρικτής	υποστηρικτ	noun-masc-ης
υποσχόμενος	υποσχομεν	verb-
υποτελής	υποτελ	adj-ής
υποτιμώ	υποτιμ	verb-b2
υποτροφία	υποτροφι	noun-fem-α
υπουργείο	υπουργειο	noun-neut-ο
υπουργός	υπουργ	noun-neut-ι
υποφέρω	υποφερ	verb-a
υποχρέωση	υποχρεωσ	noun-fem-η
υποχρεούμαι	υποχρεου	verb-
υποχρεωτικός	υποχρεωτικ	adj-ός
υποχρεώνω	υποχρεω	verb-a
υποχωρώ	υποχωρ	verb-b2
υποχώρηση	υποχωρησ	noun-fem-η
υποψήφιος	υποψηφι	adj-ος
υποψία	υποψι	noun-fem-α
υποψηφιότητα	υποψηφιοτητ	noun-fem-α
υποψιάζομαι	υποψιαζ	verb-παθ
υπό	υπό	adp
υπόδειγμα	υποδειγ	noun-neut-μα
υπόθεση	υποθεσ	noun-fem-η
υπόλειμμα	υπολειμ	noun-neut-μα
υπόλογος	υπολογ	adj-ος
υπόλοιπος	υπολοιπ	adj-ος
υπόσχεση	υποσχεσ	noun-fem-η
υπόσχομαι	υποσχ	verb-παθ
υπόψη	υπόψη	adv
υφή	υφ	noun-fem-η
υφίσταμαι	υφιστ	verb-
υφηγητής	υφηγητ	noun-masc-ης
υφιστάμενος	υφισταμεν	adj-ος
υφυπουργός	υφυπουργ	noun-neut-ι
υψόμετρο	υψομετρ	noun-neut-ο
υψώνω	υψων	verb-a
φάκελος	φακελο	noun-masc-ος
φάρμακο	φαρμακ	noun-neut-ο
φάρος	φαρ	noun-masc-ος
φάση	φασ	noun-fem-η
φάσμα	φασ	noun-neut-μα
φέρω	φερ	verb-a
φέτος	φέτος	adv
φήμη	φημ	noun-fem-η
φίλος	φιλ	noun-masc-ος
φαίνομαι	φαιν	verb-παθ
φαγητό	φαγητ	noun-neut-ο
φαινόμενο	φαινομεν	noun-neut-ο
φανατικός	φανατικ	adj-ός
φανερός	φανερ	adj-ός
φανερώνω	φανερων	verb-a
φαράγγι	φαραγγι	noun-neut-ι
φαρμακοποιός	φαρμακοποι	noun-neut-ι
φασιστικός	φασιστικ	adj-ός
φεντεραλιστής	φεντεραλιστ	noun-masc-ης
φετινός	φετιν	adj-ός
φεύγω	φευγ	verb-a
φθάνω	φθαν	verb-a
φθορά	φθορά	noun
φιλελεύθερος	φιλελευθερ	adj-ος
φιλικός	φιλικ	adj-ός
φιλοδοξία	φιλοδοξι	noun-fem-α
φιλοξενούμενος	φιλοξενουμεν	adj-ος
φιλοξενώ	φιλοξεν	verb-b2
φιλοσοφία	φιλοσοφι	noun-fem-α
φλεγόμενος	φλεγομεν	adj-ος
φλούδα	φλουδ	noun-fem-α
φοβούμαι	φοβ	verb-
φοιτητής	φοιτητ	noun-masc-ης
φοιτητικός	φοιτητικ	adj-ός
φονικός	φονικ	adj-ός
φονταμενταλισμός	φονταμενταλισμ	noun-neut-ι
φορά	φορά	noun
φορέας	φορε	noun-masc-ας
φορολογία	φορολογι	noun-fem-α
φορολογικός	φορολογικ	adj-ός
φορτηγός	φορτηγ	noun-neut-ι
φραγμός	φραγμο	noun-neut-ι
φρεγάτα	φρεγατ	noun-fem-α
φρικιαστικός	φρικιαστικ	adj-ός
φρούριο	φρουριο	noun-neut-ο
φτάνω	φταν	verb-a
φτηνός	φτην	adj-ός
φτιάχνω	φτιαχν	verb-a
φυγή	φυγ	noun-fem-η
φυγαδεύω	φυγαδευ	verb-a
φυλάγω	φυλαγ	verb-a
φυλάκιο	φυλακ	noun-neut-ο
φυλάκιση	φυλακιση	noun-fem-η
φυλή	φυλ	noun-fem-η
φυλακή	φυλακ	noun-fem-η
φυλακίζω	φυλακιζ	verb-a
φυλετικός	φυλετικ	adj-ός
φυσικά	φυσικά	adv
φυσικός	φυσικ	adj-ός
φυτό	φυτ	noun-neut-ο
φωνή	φων	noun-fem-η
φως	φως	noun
φωταγώγηση	φωταγωγησ	noun-fem-η
φόρος	φορ	noun-masc-ος
φύκος	φυκ	noun-masc-ος
φύλλο	φυλλ	noun-neut-ο
φύλο	φυλ	noun-neut-ο
φύση	φυσ	noun-fem-η
φώκια	φωκι	noun-fem-α
χάνω	χαν	verb-a
χάραξη	χαραξ	noun-fem-η
χάρη	χάρη	adv
χάρτης	χαρτ	noun-masc-ης
χάσμα	χασ	noun-neut-μα
χέρι	χερι	noun-neut-ι
χίλιων	χίλιων	adj
χαίρω	χαιρ	verb-a
χαιρετίζω	χαιρετι	verb-a
χαλάζι	χαλαζι	noun-neut-ι
χαλάρωση	χαλαρωσ	noun-fem-η
χαλαζόπτωση	χαλαζοπτωσ	noun-fem-η
χαλαρός	χαλαρ	adj-ός
χαμένος	χαμεν	verb-
χαμηλός	χαμηλ	adj-ός
χαμόγελο	χαμογελ	noun-neut-ο
χαντάκι	χαντακι	noun-neut-ι
χαρά	χαρά	noun
χαράζω	χαραζ	verb-a
χαρακτήρας	χαρακτηρ	noun-masc-ας
χαρακτηρίζω	χαρακτηρι	verb-a
χαρακτηριστικό	χαρακτηριστικ	noun-neut-ο
χαρακτηριστικός	χαρακτηριστικ	adj-ός
χαροποιώ	χαροποι	verb-b2
χαρτί	χαρτί	noun
χαρτογράφηση	χαρτογραφηση	noun-fem-η
χαρτονόμισμα	χαρτονομισ	noun-neut-μα
χείρα	χειρ	noun-fem-α
χειρισμός	χειρισμο	noun-neut-ι
χειροβομβίδα	χειροβομβιδ	noun-fem-α
χειροκρότημα	χειροκροτη	noun-neut-μα
χειροτερεύω	χειροτερευ	verb-a
χειρόγραφο	χειρογραφ	noun-neut-ο
χερσαίος	χερσαι	adj-ος
χερσόνησος	χερσονησ	noun-masc-ος
χημικός	χημικ	adj-ός
χθες	χθες	adv
χθεσινός	χθεσιν	adj-ός
χιλιάδα	χιλιάδα	num
χιλιόμετρο	χιλιομετρ	noun-neut-ο
χιονόπτωση	χιονοπτωσ	noun-fem-η
χλωρίδα	χλωριδ	noun-fem-α
χορήγηση	χορηγηση	noun-fem-η
χορηγώ	χορηγ	verb-b2
χουρμάς	χουρμάς	noun
χούντα	χούντα	propn
χρέος	χρε	noun-masc-ος
χρήμα	χρημα	noun-neut-μα
χρήση	χρηση	noun-fem-η
χρήσιμος	χρησιμ	adj-ος
χρήστης	χρηστ	noun-masc-ης
χρίσμα	χρισ	noun-neut-μα
χρειάζομαι	χρεια	verb-παθ
χρεώνω	χρεων	verb-a
χρηματαγορά	χρηματαγορά	noun
χρηματικός	χρηματικο	adj-ός
χρηματοδοτούμενος	χρηματοδοτουμεν	adj-ος
χρηματοδοτώ	χρηματοδοτ	verb-b2
χρηματοδότηση	χρηματοδοτησ	noun-fem-η
χρηματοπιστωτικός	χρηματοπιστωτικ	adj-ός
χρησιμεύω	χρησιμευ	verb-a
χρησιμοποιώ	χρησιμοποι	verb-b2
χρησιμότητα	χρησιμοτητ	noun-fem-α
χριστιανικός	χριστιανικ	adj-ός
χριστιανοδημοκρατικός	χριστιανοδημοκρατικ	adj-ός
χριστιανός	χριστιαν	noun-neut-ι
χριστός	χριστός	propn
χρονιά	χρονιά	noun
χρονικός	χρονικ	adj-ός
χρυσή	χρυσή	propn
χρυσός	χρυσ	adj-ός
χρωματίζω	χρωματιζ	verb-a
χρωστικός	χρωστικ	adj-ός
χρόνιος	χρονι	adj-ος
χρόνος	χρον	noun-masc-ος
χρώμα	χρω	noun-neut-μα
χτίζω	χτιζ	verb-a
χτυπώ	χτυπ	verb-b2
χωρίς	χωρίς	adp
χωριό	χωρι	noun-neut-ο
χωροφυλακή	χωροφυλακ	noun-fem-η
χώρα	χωρ	noun-fem-α
χώρος	χωρο	noun-masc-ος
ψάρι	ψαρι	noun-neut-ι
ψάχνω	ψαχν	verb-a
ψήφισμα	ψηφισμα	noun-neut-μα
ψήφος	ψηφ	noun-masc-ος
ψηλός	ψηλ	adj-ός
ψηφίζω	ψηφι	verb-a
ψηφιακός	ψηφιακ	adj-ός
ψηφοφορία	ψηφοφορι	noun-fem-α
ψυχή	ψυχ	noun-fem-η
ψωνίζω	ψωνιζ	verb-a
ων		verb-
ωραίος	ωραι	adj-ος
ωραιοποιώ	ωραιοποι	verb-b2
ωριμάζω	ωριμαζ	verb-a
ως	ως	adv
ωστόσο	ωστόσο	cconj
ωφελώ	ωφελ	verb-b2
ό,τι	ο,τι	pron-neut-ι
όγκος	ογκο	noun-masc-ος
όζον	όζον	noun
όλο	όλο	adv
όλος	ολ	adj-ος
όμηρος	ομηρ	noun-masc-ος
όμιλος	ομιλ	noun-masc-ος
όμορφος	ομορφ	adj-ος
όμως	όμως	adv
όνειρο	ονειρ	noun-neut-ο
όνομα	ονομα	noun-neut-μα
όντως	όντως	adv
όπλο	οπλ	noun-neut-ο
όποιος	οποι	pron-masc-ος
όπου	όπου	adv
όπως	όπως	adv
όργανο	οργαν	noun-neut-ο
όριο	ορ	noun-neut-ο
όρκος	ορκ	noun-masc-ος
όρος	ορ	noun-masc-ος
όσο	όσο	adv
όσος	οσ	pron-masc-ος
όταν	όταν	sconj
ότι	ότι	sconj
ότου	ότου	adv
όφελος	οφελ	noun-masc-ος
όχημα	οχημα	noun-neut-μα
όχθη	οχθ	noun-fem-η
όχι	όχι	part
όψη	οψ	noun-fem-η
ύδωρ	ύδωρ	noun
ύμνος	υμν	noun-masc-ος
ύπαρξη	υπαρξ	noun-fem-η
ύπατος	υπατ	adj-ος
ύποπτος	υποπτ	adj-ος
ύστερα	ύστερα	adv
ύστερος	υστερ	noun-masc-ος
ύφεση	υφεσ	noun-fem-η
ύψιστος	υψιστ	adj-ος
ύψος	υψ	noun-masc-ος
ύψωμα	υψω	noun-neut-μα
ώθηση	ωθησ	noun-fem-η
ώρα	ωρ	noun-fem-α
ώσπου	ώσπου	sconj
ώστε	ώστε	sconj